latin_input	devanagari_prediction	devanagari_target
ank	अंक	अंक
anka	अंका	अंक
ankit	अनकीत	अंकित
anakon	अनकों	अंकों
ankhon	अंखों	अंकों
ankon	अनकों	अंकों
angkor	अंगोर	अंकोर
ankor	एंकोर	अंकोर
angaarak	अंगारक	अंगारक
angarak	अंगरक	अंगारक
angraji	अंगरजजी	अंग्रज़ी
angreji	अग्रेजी	अंग्रज़ी
angrzi	अंगरजी	अंग्रज़ी
antah	अंताह	अंतः
antaha	अंताहा	अंतः
antarmukh	अंतरमखख	अंतर्मुख
antmurkh	अंतरूख्	अंतर्मुख
antrmukh	अंतरमखख	अंतर्मुख
andrabee	अंदरबाी	अंद्राबी
andrabi	अंदरबाबी	अंद्राबी
andha	अंधा	अंधा
andhapan	अंधापन	अंधापन
andheri	अंधेरी	अंधेरी
ambaani	अंबानी	अंबानी
ambani	अंबानी	अंबानी
akram	अक्रम	अकरम
acapulco	अकापुल्क	अकापुल्को
akapulko	अकापुको	अकापुल्को
akhand	अखंड	अखंड
akhil	अखिल	अखिल
agavai	अगवाई	अगवाई
agvaai	अगवाई	अगवाई
augustine	औगस्टीन	अगस्टाइन
augustustine	आगुस्ट्यासिन	अगस्टाइन
agsta	अग्सता	अगस्ता
agusta	अगुस्त	अगस्ता
augusta	औगस्त	अगस्ता
agr	एग्र	अग्र
agra	अग्रा	अग्र
achambha	अचंभा	अचंभा
achanbha	अचंभा	अचंभा
achievement	अचिमेमेंट	अचीवमेंट
achivement	अचिमेमेंट	अचीवमेंट
acchi	अच्छी	अच्छी
achchi	अच्छी	अच्छी
achhi	अछी	अच्छी
achyut	अच्युत	अच्युत
achhanera	अच्नारा	अछनेरा
achnera	अचनरा	अछनेरा
ajmeedh	अजमीदध	अजमीढ़
ajhar	अजार	अजहर
azhar	अजहर	अजहर
ajit	अजीत	अजित
agnat	अग्नत	अज्ञात
agyaat	अज्ञात	अज्ञात
agyat	अज्ञात	अज्ञात
atakta	अतकता	अटकता
atkata	अट्कता	अटकता
atake	अटेके	अटके
atke	एटे	अटके
atwaal	अत्वाल	अटवाल
atwal	अत्वल	अटवाल
attahasa	अत्तासाह	अट्टहास
atthaas	अत्थास	अट्टहास
atthas	अत्थास	अट्टहास
addon	एड़ों	अड्डों
athak	अथाक	अथक
atharv	अठारवव	अथर्व
atharva	अठारवव	अथर्व
adad	अदाद	अदद
adaani	अदानी	अदाणी
adani	आदनी	अदाणी
advait	एडवाइट	अद्वैत
adwait	एडवाइट	अद्वैत
advaitvaad	अद्वतववाद	अद्वैतवाद
advaitwad	अदववतादाद	अद्वैतवाद
adhivas	अधिवास	अधिवास
adhiwas	अधिवास	अधिवास
advivas	अदविवास	अधिवास
adhiik	अधिक	अधीक
adhik	अधिक	अधीक
adhyayanarat	अध्यनारता	अध्ययनरत
adhyayanrat	अध्ययनरत	अध्ययनरत
adhyaynrat	अध्ययनर्त	अध्ययनरत
anant	अनांत	अनंत
ananti	अनाती	अनंती
angadh	अंगढ़	अनगढ़
angarh	अंगरह	अनगढ़
anchahe	अंचाहे	अनचाहे
anthak	अंठक	अनथक
unthak	उंठक	अनथक
anhoni	अन्होनी	अनहोनी
anaavashyak	अनावाश्यक	अनावश्यक
anavashyak	अनावाश्यक	अनावश्यक
anavshyak	अनावश्यक	अनावश्यक
anawashyak	अनावाश्यक	अनावश्यक
anik	अनिक	अनिक
anishwarvadi	अनिश्वर्वादी	अनीश्वरवादी
anishwarwadi	अनिश्ववादी	अनीश्वरवादी
anukoltha	अनुकोल्ठ	अनुकूलता
anukulata	अनुकुलता	अनुकूलता
anukulta	अनुकुलता	अनुकूलता
anuchit	अनुचित	अनुचित
anuprayogi	अनुपर्गोयी	अनुप्रयोगों
anuprayogon	अनुपर्गोों	अनुप्रयोगों
anupryogon	अनुप्रोगों	अनुप्रयोगों
anureet	अनुरीत	अनुरीत
anurit	अनुरित	अनुरीत
anuthi	अनुठी	अनूठी
anudit	अनुदित	अनूदित
anyaay	अन्याय	अन्याय
anyay	अन्यय	अन्याय
anyaya	अन्यय	अन्याय
apnani	अपनानी	अपनानी
aparivartanshali	अपरिवर्सनली	अपरिवर्तनशील
aparivartansheel	अपरिवर्सनलीथ	अपरिवर्तनशील
aparivartanshil	अपरिवर्सनलीथ	अपरिवर्तनशील
apariharya	अपरिहार्य	अपरिहार्य
aprihary	अपरिहारीय	अपरिहार्य
apriyary	अप्रियाय	अपरिहार्य
apavartit	अपवर्तित	अपवर्तित
apvartit	अपवर्तित	अपवर्तित
apvtrit	अप्वतृत	अपवर्तित
apaardarshi	अपररदश्शी	अपारदर्शी
apardarshi	अपररर्शी	अपारदर्शी
afroj	अफरोज	अफरोज
afroz	अफरोज	अफरोज
africa	अफ्रीका	अफ्रीका
abbaasi	अब्ासी	अब्बासी
abbasi	अब्बासी	अब्बासी
abhimat	अभिमत	अभिमत
abhishap	अभिषाप	अभिशाप
abhi	अभी	अभी
amjhera	अमझेरा	अमझेरा
amzera	अमजेरा	अमझेरा
amargad	अमरगद	अमरगढ़
amargarh	अमरगढ़	अमरगढ़
amarpaal	अमरपाल	अमरपाल
amarpal	अमरपल	अमरपाल
amarohi	अमरोही	अमरोही
amrohi	अमरोही	अमरोही
amaanat	अमानत	अमानत
amanat	अमानत	अमानत
amanth	अमंथ	अमानत
amaanati	अमानती	अमानती
amanathi	अमानथी	अमानती
amanati	अमानती	अमानती
amavasya	अमावस्य	अमावस्या
amavsya	अमाव्य	अमावस्या
amit	अमीट	अमित
amitao	अमिटाओ	अमिताव
amitav	अमीतव	अमिताव
amuk	आमूक	अमुक
amogh	अमोघ	अमोघ
ambani	अंबानी	अम्बानी
ayodhyaanaath	अयोधनायाथ	अयोध्यानाथ
ayodhyanaath	अयोधनायाथ	अयोध्यानाथ
ayodhyanath	अयोध्यनाथ	अयोध्यानाथ
ayodhyeanath	अयोध्यानीथ	अयोध्यानाथ
aradas	अरदास	अरदास
ardaas	अर्दास	अरदास
ardas	अर्दास	अरदास
arabab	अरबबब	अरबाब
arbab	अरबबब	अरबाब
around	आरोंड	अराउंड
arjent	अर्जेंट	अर्जेंट
urgent	उर्जेंट	अर्जेंट
arth	अर्थ	अर्थ
artha	अर्था	अर्थ
earth	एर्थ	अर्थ
earthquake	इर्थक्यूक	अर्थक्वेक
arthon	अर्थों	अर्थों
arpit	अर्पिट	अर्पित
aryama	आर्यमा	अर्यमा
aryma	आर्मा	अर्यमा
arymaa	आर्मा	अर्यमा
alankaar	अलंकर	अलंकार
alankar	अलंकर	अलंकार
alnkaar	अल्कार	अलंकार
alankaaron	अलंकारों	अलंकारों
alankaron	अलंकरों	अलंकारों
alnkaaron	अल्कारों	अलंकारों
alnkaron	अलंकरों	अलंकारों
alagavavadi	अलावादावी	अलगाववादी
algavvadi	अल्वादवाजी	अलगाववादी
algavwaadi	अल्वावादी	अलगाववादी
alive	अलीव	अलाइव
alance	एलांस	अलायंस
alayans	अलायंस	अलायंस
aliance	एलाइंस	अलायंस
alind	एलिंड	अलिंद
alai	एलाई	अली
ali	एली	अली
alii	एली	अली
alonso	एलोंस	अलोंसो
aloso	एलोसो	अलोंसो
alphabet	अल्फाेबेट	अल्फ़ाबेट
alba	अलबा	अल्बा
avantipur	अवंतीपुर	अवंतिपुर
awantipora	अवंतपीरित	अवंतिपुर
avaru	अवरू	अवरु
avru	अवरू	अवरु
awaru	अवारू	अवरु
avarodhak	अवरोधक	अवरोधक
avrodhak	अवरोधक	अवरोधक
avrodhk	अवरोधक	अवरोधक
avarnata	अवर्णता	अवर्णता
avarnataa	अवर्णता	अवर्णता
avranta	अवर्तना	अवर्णता
avashist	अवशिस्त	अवशिष्ट
avshisht	अवशिष्ट	अवशिष्ट
awashist	अवशिस्त	अवशिष्ट
avasthaayen	अवस्थाएं	अवस्थाएं
avsthaen	अवस्थाएं	अवस्थाएं
avsthayen	अवस्थाएं	अवस्थाएं
awasthaen	अवस्थाएं	अवस्थाएं
avi	अवी	अवि
avika	अविका	अविका
aviral	अविरल	अविरल
avirl	अवररल	अविरल
avishvaasniy	अविश्वासनीय	अविश्वसनीय
avishvasniy	अविश्वसनीय	अविश्वसनीय
avishvasniya	अविश्वसनीय	अविश्वसनीय
avisvasniya	अविस्वानीय	अविश्वसनीय
aviva	अविवा	अवीवा
avaigyanic	अवैज्यानिक	अवैज्ञानिक
avaigyanik	अवैज्ञानिक	अवैज्ञानिक
avegyanik	अवेजनायिक	अवैज्ञानिक
ashaktataa	आशक्तता	अशक्तता
ashktta	अशक्तता	अशक्तता
asharaphi	अशरपी	अशरफी
ashrafi	अश्रफी	अशरफी
ashariri	अशरीरी	अशरीरी
ashriri	अश्रीरी	अशरीरी
ashrvatath	अश्वर्थत	अश्वत्थ
ashvtth	अश्वत्थ	अश्वत्थ
asamaany	असमान्य	असमान्य
asamany	असमान्य	असमान्य
asmanye	असमान्य	असमान्य
asaamnjsy	असामंज्य	असामंजस्य
asamanjasy	असममजस्ञ	असामंजस्य
asamanjasya	असममजस्ञत	असामंजस्य
asurakshit	असुरक्षित	असुरक्षित
asurkshit	असुरक्षित	असुरक्षित
aset	एसेट	असेट
asset	एसेटट	असेट
asvabhavik	अस्वाभाविक	अस्वभाविक
aswabhavik	अस्वाभाविक	अस्वभाविक
aswbhavik	अस्वभाविक	अस्वभाविक
ahirauli	अहिराली	अहिरौली
item	आईटम	आइटम
items	इटम्स	आइटम्स
idle	इडल	आइडल
idol	इडोल	आइडल
icc	आईसीसी	आइसीसी
iso	इसो	आइसो
ipc	आईपीसी	आईपीसी
ipad	आईपीडी	आईपैड
iris	इरिस	आईरिस
ounce	आउंसे	आउंस
aakaash	आकाश	आकाश
aakash	आकाश	आकाश
aake	आके	आके
aakhet	आखेत	आखेट
akhet	अखेत	आखेट
aagat	आगत	आगत
aagaman	आगमन	आगमन
aagman	आगमान	आगमन
aagaa	आगा	आग़ा
aagah	आगाह	आग़ा
agha	आघा	आग़ा
aagaashe	आगाशे	आगाशे
aagashe	आगाशे	आगाशे
agashe	अगाशे	आगाशे
aajmaanaa	आजमाना	आजमाना
aajmana	आजमाना	आजमाना
aazmaanaa	आजमाना	आजमाना
aata	आता	आटा
ata	अता	आटा
atta	अत्ता	आटा
aatmayen	आत्माएं	आत्माएं
atmaen	आतमाएं	आत्माएं
aadaan	आदान	आदान
aadan	आदन	आदान
aadhaarit	आधारित	आधारित
aadharit	आधारित	आधारित
adharit	अधारित	आधारित
aadheen	आधीन	आधीन
aadhin	आधीन	आधीन
aadhunik	आधुनिक	आधुनिक
aanad	आनाद	आनद
aanand	आनंद	आनद
anand	अनंद	आनद
aapka	आपका	आपका
aapkaa	आपका	आपका
aapadaaaen	आपडाएं	आपदाएं
aapdaein	आपदाएं	आपदाएं
aapdayein	आपदाएं	आपदाएं
aabantit	आबंतित	आबंटित
abantit	अबंतित	आबंटित
aabru	आबरू	आबरू
abaru	अबरू	आबरू
aamdan	आमदन	आमदन
amadan	अमादन	आमदन
aamdani	आमदानी	आमदनी
amadani	अमादनी	आमदनी
aamdi	आमदी	आमदी
amdi	अमडी	आमदी
aamod	आमोड	आमोद
amod	अमोड	आमोद
aayenge	आयेंगे	आयेंगे
aayojak	आयोजक	आयोजक
ro	रो	आरओ
rp	आरपी	आरपी
aaraam	आराम	आराम
aaram	आरम	आराम
aram	आरम	आराम
aarushi	आरुशी	आरुषि
arushi	अरुशी	आरुषि
artery	आर्टी	आर्टरी
order	ओर्डर	आर्डर
aary	आर्य	आर्य
aarya	आर्य	आर्य
arya	आर्य	आर्य
aaryika	आर्यिका	आर्यिका
aryika	आर्यिका	आर्यिका
aarya	आर्य	आर्यो
arya	आर्य	आर्यो
aryo	आर्यो	आर्यो
aaryan	आर्यन	आर्यों
arya	आर्य	आर्यों
aryon	आर्यों	आर्यों
aalsi	आलसी	आलसी
alasi	अलासी	आलसी
aalochak	आलोचक	आलोचक
alochak	अलोचक	आलोचक
aalochakon	आलोचकों	आलोचकों
alochakon	आलोचकों	आलोचकों
aalha	आल्हा	आल्हा
aalhaa	आल्हा	आल्हा
alha	अल्हा	आल्हा
allah	अल्हाह	आल्हा
aawaazen	आवाजें	आवाज़ें
aawajen	आवाजें	आवाज़ें
awaazen	आवाजें	आवाज़ें
awazen	आवाजें	आवाज़ें
aawajon	आवाजों	आवाज़ों
aawazon	आवाजों	आवाज़ों
awaazon	आवाजों	आवाज़ों
awazon	आवाजों	आवाज़ों
aavishakaar	आविष्कार	आविष्कार
aavishkaar	आविष्कार	आविष्कार
avishkar	अविष्कार	आविष्कार
aavriti	आवृति	आवृत्ति
aavritti	आवृत्ति	आवृत्ति
avuti	अवूति	आवृत्ति
aavritiyon	आवृतियों	आवृत्तियों
aavrittiyon	आवृत्टियों	आवृत्तियों
avrutiyon	अवृतियों	आवृत्तियों
aashanka	आशंका	आशंका
ashanka	अशंका	आशंका
aashriton	आश्रितों	आश्रितों
ashriton	अश्रितों	आश्रितों
aasaan	आसान	आसान
aasan	आसन	आसान
asan	असन	आसान
aastik	आस्तिक	आस्तिक
astik	अस्तिक	आस्तिक
aasteen	आस्तीन	आस्तीन
aastin	आस्टीन	आस्तीन
astin	अस्टीन	आस्तीन
aahnaan	आहनान	आह्नान
aahnan	आहनन	आह्नान
ahyan	अह्यान	आह्नान
england	एंगलैंड	इंग्लैंड
engineer	इंजीनियर	इंजिनियर
introduction	इंटरकोर्शनन	इंट्रोडक्शन
insurance	इनसर्स	इंश्योरेंस
ear	एर	इअर
eyer	एयर	इअर
eon	ईन	इआन
iaan	आईएन	इआन
ekattha	इक्ठता	इकट्ठा
ikattha	इक्ठता	इकट्ठा
ekatthi	इक्ठठी	इकठ्ठी
ekthi	इक्ठी	इकठ्ठी
ikatthi	इकात्थी	इकठ्ठी
ekaee	एकाई	इकाई
ikai	इकाई	इकाई
ekaeyon	एकाईयों	इकाईयों
ikaiyon	इकाईयों	इकाईयों
ikarion	इकारियों	इकाईयों
economic	इकोनोमिक	इकोनोमिक
ecuador	एक्यूडर	इक्वाडोर
equador	एक्वोदर	इक्वाडोर
equities	एकिविटज	इक्विटीज
ikvitija	इक्विजित	इक्विटीज
ijaajat	इजाजात	इजाजत
ijajat	इजाजत	इजाजत
inhalation	इंहलाइनं	इनहेलेशन
inhaletion	इन्लेहें	इनहेलेशन
ibija	इबिजा	इबीजा
ibiza	इबिजा	इबीजा
imaging	इमाइजिंग	इमेजिंग
immune	इम्यून	इम्युन
elaichi	एलाईी	इलाइची
ilaichi	इलाईची	इलाइची
ilayachi	इलायाची	इलाइची
ilayichi	इलायिची	इलाइची
elaaj	एलाज	इलाज
ilaaj	इलाज	इलाज
ilaj	इलाज	इलाज
ishaak	इशाक	इशाक
ishaaq	इशाक	इशाक
ishak	इशाक	इशाक
ishaara	इशारा	इशारा
ishaaraa	इशारा	इशारा
ishara	इशारा	इशारा
ishita	इशिता	इशिता
isht	इश्त	इष्ट
isteefe	इस्टीफे	इस्तीफे
istife	इस्टीफ	इस्तीफे
ea	ई	ईए
ia	आई	ईए
eater	इटर	ईटर
iter	इटर	ईटर
email	एमलल	ईमेल
emailon	एमालों	ईमेलों
emelon	एमलों	ईमेलों
evening	एवेनिंग	ईवनिंग
east	ईस्ट	ईष्ट
ishat	इशात	ईष्ट
isht	इश्त	ईष्ट
isaaiyon	ईसाईयों	ईसाइयों
isaiyon	ईसाईयों	ईसाइयों
isayiyon	ईसाईयों	ईसाइयों
ikhrul	इखरुल	उखरुल
ukhrool	उखरूल	उखरुल
ukhrul	उखरूल	उखरुल
uchhalane	उचलने	उछालने
uchhalne	उछलने	उछालने
ujback	उजजबक	उज़्बेक
uzbek	उज़ेबक	उज़्बेक
uthane	उठाने	उठने
uthne	उठने	उठने
uthaakar	उठाकर	उठाकर
uthakar	उठाकर	उठाकर
uthaapatak	उठापकत	उठापटक
uthapatak	उठापकत	उठापटक
uthen	उठें	उठें
udaan	उदान	उड़ान
udan	उदन	उड़ान
udaanaa	उदाना	उड़ाना
udana	उड़ना	उड़ाना
udaane	उदाने	उड़ाने
udane	उड़ने	उड़ाने
udaanen	उदानें	उड़ानें
udanen	उदानें	उड़ानें
udaanon	उदानों	उड़ानों
udanon	उदानों	उड़ानों
utane	उतने	उतने
utaney	उतने	उतने
utne	उतने	उतने
uttara	उत्तरा	उत्तरा
uttra	उत्तर	उत्तरा
utpan	उत्पन	उत्पन
udant	उदांत	उदंत
udghosh	उद्घोष	उदघोष
udar	उदार	उदर
uda	उड़ा	उदा
udaa	उड़ा	उदा
udakishuganj	उद़िकगगगग	उदाकिशुनगंज
udakishunganj	उदकिगुगंग	उदाकिशुनगंज
unatees	उन्तीस	उनतीस
untees	उन्टीस	उनतीस
uniyal	यूनियल	उनियाल
upadraviyon	उपद्रवियों	उपद्रवियों
updravion	उपद्रवहियों	उपद्रवियों
updraviyon	उपद्रवियों	उपद्रवियों
upadravi	उपद्रवी	उपद्रवी
updravi	उपद्रवी	उपद्रवी
upadrawon	उपद्रावों	उपद्रवों
updravon	उपद्रवों	उपद्रवों
upneta	उपनेता	उपनेता
upabhokta	उपभाक्त	उपभोक्ता
upbhokta	उपभोकता	उपभोक्ता
uplaksh	उपलक्ष	उपलक्ष्य
uplakshay	उपलक्षय	उपलक्ष्य
uplakshya	उपलक्ष्य	उपलक्ष्य
uplabdh	उपलाब्ध	उपलब्ध
uplabdhiyon	उपलाब्धियों	उपलब्धियों
uplabdhi	उपलाबदधि	उपलब्धी
upakhyaanon	उपख्याओंं	उपाख्यानों
upakhyanon	उपख्याओं	उपाख्यानों
ubuntu	उबूंु	उबंटू
ubaal	उबाल	उबाल
ubal	उबल	उबाल
ubhaara	उभारा	उभारा
ubhara	उभरा	उभारा
umanath	उमनाथ	उमानाथ
umesh	उमेश	उमेश
urf	उर्फ	उर्फ
urfa	उर्फा	उर्फ
urff	अर्फफ	उर्फ
urvarakon	उर्वाकरों	उर्वरकों
urvarkon	उर्वाकों	उर्वरकों
urwarakon	उर्वाकरों	उर्वरकों
urvarata	उर्वारता	उर्वरता
urvarta	उर्वर्त	उर्वरता
urwarta	उर्वरता	उर्वरता
ulate	उलते	उलटे
ulte	उल्टे	उलटे
ulahana	उलहना	उलाहना
ulahna	उलहना	उलाहना
ulema	उलेमा	उलेमा
ulemaon	उलेमाओं	उलेमाओं
usak	उसक	उसक
usaki	उसकी	उसकी
uski	उसकी	उसकी
usmein	उसममें	उसमें
usmen	उसमें	उसमें
usi	यूसी	उसी
ustara	उस्तरा	उस्तरा
udharv	उधर्व	ऊर्ध्व
udhrva	उध्रव	ऊर्ध्व
urdhav	उर्धव	ऊर्ध्व
ushma	उष्मा	ऊष्मा
rishicool	रिशिकल	ऋषिकुल
rishikul	ऋषिकुल	ऋषिकुल
rushikul	ऋषिकुल	ऋषिकुल
enzyme	इंजेयम	एंजाइम
anton	एंटों	एंटोन
entone	एंटोन	एंटोन
antoni	एंटोनी	एंटोनी
antony	एंटोनी	एंटोनी
endometrial	इंडोमेटरियम	एंडोमेट्रियल
andreas	एंड्रेस	एंड्रियास
als	एल्स	एएलएस
asi	एसी	एएसआई
eksaath	एक्साथ	एकसाथ
eksath	एक्सठ	एकसाथ
ekaki	एकाी	एकाकी
xm	एक्स	एक्सएम
egmor	एगमर	एगमोर
egmore	एगमरे	एगमोर
aj	अज	एजे
agende	अजेंडे	एजेंडे
adp	एपीी	एडीपी
adain	एडान	एडेन
aden	एडन	एडेन
edan	एडन	एडेन
addi	एडी	एड्डी
eddi	एडीी	एड्डी
eddie	एडी	एड्डी
eddy	एडीी	एड्डी
apj	अपज	एपीजे
ftii	फ़ीटी	एफटीआईआई
abbott	एब्बोटट	एबट
abut	अबूत	एबट
ebt	एबीटीी	एबट
abvp	एब्पीपी	एबीवीपी
abbot	एब्बोट	एबोट
abbott	एब्बोटट	एबोट
mta	मा	एमटीए
mtake	मटके	एमटेक
mtec	मेटीकी	एमटेक
mtech	मेटच	एमटेक
emerald	एमरलल्ड	एमरल्ड
emrald	एमरलल्ड	एमरल्ड
emil	एमिल	एमिल
emile	एमिले	एमिल
emily	एमिली	एमिल
amy	एम्य	एमी
emi	एमी	एमी
airway	एयरवे	एयरवे
eyarave	एयरवे	एयरवे
eyarve	एयरवे	एयरवे
error	एरोर	एरर
arica	आरिका	एरिका
erica	एरिका	एरिका
erika	एरिका	एरिका
aerobic	एयोरिकिक	एरोबिक
aerobics	एयरबिक्सस	एरोबिक
lte	लेट	एलटीई
lti	लटी	एलटीई
allergic	एल्रेजिक	एलर्जिक
eliminator	एलिमेनेटर	एलिमिनेटर
aliens	एलिंस	एलियंस
alliance	एलाइंस	एलियंस
asian	असीयन	एशियन
sfc	एसफीसी	एसएफसी
sk	ससएक	एसके
spf	एसपीफी	एसपीएफ
association	एसोसिएशन	एसोसिएशन
astar	अस्तर	एस्टर
aster	एस्टर	एस्टर
ester	एस्टर	एस्टर
aesthetics	एस्टेक्टिस	एस्थेटिक
asthetic	अस्थेकिट	एस्थेटिक
asfalt	अस्फल्ट	एस्फाल्ट
asphalt	अस्फलत	एस्फाल्ट
asphault	असफलात	एस्फाल्ट
ahsaas	अहसास	एहसास
ehsaas	एहसास	एहसास
ehsas	एहसस	एहसास
aisa	एसा	एेसा
eesa	ईसा	एेसा
ainth	ऐंठ	ऐंठ
end	एंड	ऐंठ
enth	एंथ	ऐंठ
ainthey	ऐंठे	ऐंठे
enthe	एंथे	ऐंठे
aithan	ऐंठन	ऐठन
ethan	ऐंथन	ऐठन
ethhan	एठहन	ऐठन
ail	एल	ऐल
el	एल	ऐल
alaps	अलाप्स	ऐल्प्स
alps	एल्प्स	ऐल्प्स
aise	एसे	ऐसे
oxide	ओक्सीड	ऑक्साइड
oxy	ऑक्सी	ऑक्सी
offers	ऑफ्सर	ऑफर्स
offshor	ऑफ्शर	ऑफशोर
offshore	ऑफ्शर	ऑफशोर
official	ऑफिसियल	ऑफिशियल
okalahoma	ओकलहहोम	ओकलाहोमा
oklahoma	ओकलोहामा	ओकलाहोमा
oklahoma	ओकलोहामा	ओक्लाहोमा
ot	ओट	ओत
opel	ओपेल	ओपेल
obrayan	ओबररान	ओब्रायन
obrien	ओबररीन	ओब्रायन
oran	ओरन	ओरण
orian	ओरियन	ओरियन
orion	ओरियन	ओरियन
olavrishti	ओलवर्षिति	ओलावृष्टि
ovum	ओवम	ओवम
owem	आवेम	ओवम
oceanic	ओकाइनिक	ओशनिक
osaka	ओसाका	ओसाका
auchity	औचितीय	औचित्य
auchitya	औचित्य	औचित्य
audhyogikaran	औधयोगिगारक	औद्योगिकरण
audyogikarana	औदयोगिगारण	औद्योगिकरण
audyogikikaran	औद्योगिकारिकन	औद्योगिकरण
aurangabad	औरंगबाड़	औरंगाबाद
aurora	ओरोरा	औरोरा
aulakh	औलाख	औलख
kankad	कंकड़	कंकड़
kankar	कंकर	कंकड़
kankad	कंकड़	कंकर
kankar	कंकर	कंकर
kangan	कांगन	कंगन
conjunction	कंजोंटिशन	कंजंक्शन
contemporary	कंटेपर्रीय	कंटेम्पररी
kanthahar	कांथहर	कंठहार
kanthhar	काठहार	कंठहार
composer	कंपोरर	कंपोजर
kambalon	कंबलों	कंबलों
kanblon	कांबों	कंबलों
consultant	कंस्टललेट्ट	कंसलटेंट
kakkad	कक्कड़	कक्कड़
kakkar	ककककर	कक्कड़
kacche	कच्चे	कच्चे
kachche	कच्चे	कच्चे
karta	कर्ता	कटरा
katra	कत्रा	कटरा
cutlery	क्टलरी	कटलरी
katlari	कतलरी	कटलरी
katlary	काट्रीय	कटलरी
katasaraj	कटसराज	कटासराज
kathfodave	कथोफेड़े	कठफोड़वे
kathfodve	कथोफेड़	कठफोड़वे
kathor	कथोर	कठोर
kathore	कथोरे	कठोर
kanika	कनिका	कणिका
kathai	कथाई	कत्थई
katthai	कट्थाई	कत्थई
katthaii	कट्थाई	कत्थई
convention	कन्वेंशन	कनवेंशन
canals	कैनल्स	कनाल
kanaal	कनाल	कनाल
kanal	कनाल	कनाल
kanindham	कणिंधम	कनिंघम
kaningham	कनिंघम	कनिंघम
kanishthika	काशिष्चित	कनिष्ठिका
kanishthikaa	काशिष्चिता	कनिष्ठिका
kanishtika	कानिष्टिका	कनिष्ठिका
kanyaayen	कन्याएं	कन्याएं
kanyaein	कन्याएं	कन्याएं
kanyayen	कन्याएं	कन्याएं
convention	कन्वेंशन	कन्वेंशन
convocation	कनोस्टेशन	कन्वोकेशन
cup	कीपी	कप
kap	कप	कप
kapda	कपड़ा	कपड़ा
kpada	कपड़ा	कपड़ा
kapdo	कपड़ो	कपड़ो
kapdon	कपड़ों	कपड़ो
kaping	कैपिंग	कपिंग
kping	कीपिंग	कपिंग
kapolkalpana	कपपललकाना	कपोलकल्पना
kabaddi	कबददी	कबड्डी
kabr	कबर	कब्र
kabra	कबरा	कब्र
kabren	कबरें	कब्रें
kabron	कबरों	कब्रों
kamjor	कमजोर	कमज़ोर
kamzor	कमजोर	कमज़ोर
kamatar	कमतार	कमतर
kamtar	कमतर	कमतर
kalamjeet	कलमजीत	कमलजीत
kamaljeet	कमलजीत	कमलजीत
kamaauu	कमाऊ	कमाऊ
kamau	कमाऊ	कमाऊ
kamaate	कमाते	कमाते
kamate	कमते	कमाते
kamere	कमेरे	कमेरे
kmere	केमेर	कमेरे
karanj	करणज	करंज
kranj	क्रांज	करंज
karanjiya	करणजीय	करंजिया
kardhe	कर्धे	करघे
karghe	कर्घे	करघे
karachana	करचाना	करछना
karchhana	कर्चना	करछना
karna	करना	करना
karpatri	करपपति	करपात्री
karam	करम	करम
karoor	करूर	करूर
karur	करूर	करूर
karnataka	करणातक	कर्नाटका
karvi	कारवी	कर्वी
kurvi	कुर्वी	कर्वी
kalmein	कल्में	कलमें
kalmen	कल्में	कलमें
kalraj	कलराज	कलराज
kalika	कालिका	कलिका
kalpanaon	कल्पनाओं	कल्पनाओं
kalpnaon	कल्पनाओं	कल्पनाओं
kavvaliyon	कववालियां	कव्वालियों
qawwaliyon	कववालियां	कव्वालियों
kavvali	कववाली	कव्वाली
qawwali	कववाली	कव्वाली
kashton	काष्टों	कष्टों
kasarat	कसरत	कसरत
kasrat	कसरत	कसरत
kasara	कसरा	कसारा
kasida	कसीदा	कसीदा
kahane	कहाने	कहने
kahne	कहने	कहने
kahlaya	कहलाया	कहलाया
kahaniyon	कहानियों	कहानियों
kile	किले	क़िले
kanji	कंजी	कांजी
cant	कैंट	कांट
kant	कांट	कांट
kanti	कानती	कांति
kakoo	काकू	काकू
kaku	काकू	काकू
kaagaj	कागज	कागज़
kaagaz	कागज़	कागज़
kagaj	कागज़	कागज़
kagaz	कागज़	कागज़
kaaji	काजी	काजी
kaji	काजी	काजी
kazi	काजी	काजी
qazi	काजी	काजी
kajoo	काजू	काजू
kaju	काजू	काजू
kapadi	कपड़ी	कापड़ी
kapdi	कपड़ी	कापड़ी
kamraj	कामराज	कामराज
kamottejana	कमोटेटजना	कामोत्तेजना
kamottejna	कमोट्टेजन	कामोत्तेजना
kailana	कैलाना	कायलाना
kaylana	कालना	कायलाना
carfi	कारफी	कार्की
karki	कार्की	कार्की
kartik	कार्टिक	कार्तिक
karyakartaon	कार्यक्रताओं	कार्यकर्ताओं
karykartaaon	कार्यक्रताओं	कार्यकर्ताओं
karykartaon	कार्यक्रताओं	कार्यकर्ताओं
karyabhar	कार्यभर	कार्यभार
karybhar	कार्यभर	कार्यभार
karyarat	कार्यात	कार्यरत
karyrat	कार्यत	कार्यरत
kaalpi	काल्पी	कालपी
kalapi	कलापी	कालपी
kalpi	का्पी	कालपी
kalika	कालिका	कालिका
kalighat	कालिघात	कालीघाट
coldvel	कॉल्वेड	काल्डवेल
kaldvel	कालववेड	काल्डवेल
kaldwell	काल्ववलल	काल्डवेल
kaav	काव	काव
kav	काव	काव
kaasht	काष्ट	काश्त
kasht	काष्ट	काश्त
kasim	कसीम	कासिम
qasim	कसीम	कासिम
kasimabad	कासीमाबाद	कासिमाबाद
kiya	किया	किया
kiliyan	किलियां	किलियन
killat	किल्त	किल्लत
killi	किली	किल्ली
kisaani	किसानी	किसानी
kisani	किसनी	किसानी
kisanon	किसनों	किसानों
keede	कीडे	कीड़े
kide	कीड़े	कीड़े
keynote	केनोट	कीनोट
kinote	किनोटे	कीनोट
kiratpur	कीरतपुर	कीरतपुर
kundal	कुंडल	कुंडल
kundaliya	कुंडलिया	कुंडलियाँ
kundaliyan	कुंडलियां	कुंडलियाँ
kutta	कुट्ट	कुत्ता
kuposhit	कुपोशित	कुपोषित
kumau	कुमौ	कुमाऊ
kumavat	कुमावत	कुमावत
kumawat	कुमावत	कुमावत
kural	कुरल	कुराल
kurmi	कुर्मी	कुर्मी
kursiyon	कुर्सियों	कुर्सियों
kush	कुश	कुश
kushaan	कुशान	कुषाण
kushan	कुशन	कुषाण
kusumalataa	कुसुलममता	कुसुमलता
kusumalta	कुसुमलता	कुसुमलता
kusumlata	कुसलममता	कुसुमलता
koot	कूट	कूट
kut	कूट	कूट
kritika	कृतिका	कृतिका
kpo	कपप	केपीओ
canterbari	कैंटररी	कैंटरबरी
canterbury	कैंटररी	कैंटरबरी
candidate	कैडिडेट	कैंडिडेट
katrina	कतरिना	कैटरीना
caitlyn	कैटिन	कैटलिन
cateline	कैटललिन	कैटलिन
catlin	कैटलीन	कैटलिन
cadmium	कैडमियम	कैडमियम
catholic	कैथलिक	कैथोलिक
catholicon	कैथलियों	कैथोलिकों
kaetholikon	कैथिलोकों	कैथोलिकों
capacitor	कैपाकिटर	कैपेसिटर
carat	कारत	कैरेट
cavity	कैविटी	कैविटी
cavalry	कैवालीी	कैवेलरी
kaivelari	कैवेलारी	कैवेलरी
complex	कंप्लेक्स	कॉम्प्लेक्स
kocchi	कोची	कोच्चि
kochi	कोची	कोच्चि
corridor	कोरिडर	कोरिडोर
corolla	कोर्लल	कोरोला
korola	कोरोला	कोरोला
caolan	कालन	कोलन
colan	कोलन	कोलन
colon	कोलों	कोलन
calling	कैलिंग	कोलिंग
koling	कोलिंग	कोलिंग
colorado	कोलोडो	कोलोराडो
kolorado	कोलोरडो	कोलोराडो
kaushal	कौशल	कौशल
kaushalata	कौशलता	कौशलता
kaushalta	कौशलता	कौशलता
kaushambi	कौशंबी	कौशाम्बी
cute	केट	क्यूट
quete	क्वेट	क्यूट
cube	कबे	क्यूब
cubeck	केबेक	क्यूबेक
quebec	क्वेबस	क्यूबेक
cubes	कबेस	क्यूब्स
krantiyon	क्रांटियों	क्रांतियों
cric	क्रीक	क्रिक
crick	क्रीक	क्रिक
cricket	क्रिकटट	क्रिकेट
cricketer	क्रिक्टर	क्रिकेटर
cricketing	क्रिकिटिंग	क्रिकेटिंग
kriyayog	क्रियोगिया	क्रियायोग
christian	क्रिस्टियन	क्रिश्चयन
kruger	क्रेजर	क्रूगर
craig	क्रेज	क्रेग
creg	क्रेज	क्रेग
cradle	क्राडल	क्रैडल
chrom	क्रोम	क्रोम
chrome	क्रोम	क्रोम
client	क्लिइंट	क्लांइट
clock	क्लॉक	क्लाक
clasen	क्लेसन	क्लासें
classen	क्लेसन	क्लासें
classon	क्लासन	क्लासों
clay	क्ले	क्ले
claris	क्लारिस	क्लेरिस
cleris	क्लीर्स	क्लेरिस
clerys	क्लेर्स	क्लेरिस
quantico	क्वांटिको	क्वांटिको
queens	क्विंस	क्वींस
kshitij	क्षितिज	क्षितिज
shitij	शीतिज	क्षितिज
kshin	क्षीन	क्षीण
shin	शीन	क्षीण
kshetron	क्षेट्रों	क्षेत्रों
shetron	क्षेत्रों	क्षेत्रों
khand	खंड	खंडा
khanda	खंडा	खंडा
khachakhach	खच्चचच	खचाखच
khajarana	खजराना	खजराना
khajraana	खजराना	खजराना
khajrana	खजराना	खजराना
khatakati	खतकती	खटकती
khatakti	खत्तकी	खटकती
kihatkati	किहततती	खटकती
khattapan	खत्तापन	खट्टापन
khat	खत	खत
khani	खानी	खनि
khanik	खानिक	खनिक
khanikarm	खानीकारम	खनिकर्म
khanikarma	खानीकारम	खनिकर्म
khanikarmi	खानिकारी	खनिकर्म
khapat	खपत	खपत
khariya	खरिया	खरिया
khalnayak	खलनायक	खलनायक
khaaskar	खासककर	ख़ासकर
khaskar	खसककर	ख़ासकर
khaastaur	खास्तौर	ख़ासतौर
khastaur	खस्तौर	ख़ासतौर
khaibar	खैबर	ख़ैबर
khyber	खेबर	ख़ैबर
khaein	खाएं	खाएं
khaen	खाएं	खाएं
khayen	खाएं	खाएं
khaate	खाते	खाते
khaatey	खाते	खाते
khate	खाते	खाते
khal	खल	खाल
khinchakar	खींचकर	खिंचकर
khinchkar	खींचकर	खिंचकर
khilana	खिलना	खिलाना
khinchkar	खींचकर	खींचकर
khuda	खुदा	खुदा
khudai	खुड़ाई	खुदाई
khurapka	खुरपका	खुरपका
khurpaka	खुरपका	खुरपका
khurasan	खुरससन	खुरासान
khushiyan	खुशियां	खुशियां
khene	खेने	खेने
khaini	खैनी	खैनी
khairati	खैरती	खैराती
khoikhoi	खोखिया	खोईखोई
khoya	खोया	खोया
gangrel	गंगररल	गंगरेल
gangaajal	गंगाजल	गंगाजल
gangajal	गंगाजल	गंगाजल
gandaki	गंडकी	गंडकी
gandki	गंडकी	गंडकी
gandh	गंंध	गंध
gandha	गंधा	गंध
gae	गा	गए
gaye	गाये	गए
gajara	गजरा	गजरा
gajra	गजरा	गजरा
gadkar	गड़कर	गडकर
ganapati	गणपती	गणपति
ganpati	गणपती	गणपति
gatisheel	गतिशील	गतिशील
gatishil	गतिशील	गतिशील
gatishilata	गतिशिलता	गतिशीलता
gadadhar	गदाधार	गदाधर
gammat	गममात	गम्मत
gaya	गाया	गया
garibi	गरीबी	गरीबी
garjana	गर्जना	गर्जना
galgand	गललंंड	गलगंड
gahmagahmi	गहममगहीी	गहमागहमी
gemhagehmi	जहमेगमही	गहमागहमी
ganguly	गंगुली	गांगुली
gaanth	गांठ	गांठ
ganth	गंठ	गांठ
gaanthe	गांठे	गांठे
ganthe	गंठे	गांठे
ganthen	गंठें	गांठें
ganthon	गंठों	गांठों
gaen	गाएं	गाएं
gayen	गाएं	गाएं
gazi	गाजी	गाज़ी
gajipur	गाजीपुर	गाजीपुर
gazipur	गाजीपुर	गाजीपुर
gayatri	गायतत्री	गायत्री
gayitri	गैत्री	गायत्री
gaytri	गैत्री	गायत्री
gidgidate	गिड़गिडेट	गिड़गिड़ाते
ginate	गिनाते	गिनते
ginte	गिंटे	गिनते
girkar	गिरकार	गिरकर
girijaghar	गिरिजाघर	गिरजाघर
girjaghar	गिरजागार	गिरजाघर
girijagharon	गिरजागरों	गिरजाघरों
girjagharon	गिरजागारों	गिरजाघरों
girati	गिरती	गिरती
girti	गिरती	गिरती
girish	गिरीश	गिरीश
guan	गुआन	गुआन
gujar	गुजर	गुजार
gujarata	गुजराता	गुजारता
gujarta	गुजरतता	गुजारता
gujarate	गुजराते	गुजारते
gujarte	गुजरते	गुजारते
gujarana	गुजराना	गुजारना
gujarna	गुजरना	गुजारना
gujara	गुजरा	गुजारा
gujare	गुजरे	गुजारे
gutta	गुट्ता	गुट्टा
gthalidar	ग्थालीदार	गुठलीदार
guthalidar	गुतलीदार	गुठलीदार
gudna	गुड़ना	गुदना
gumaan	गुमान	गुमान
guman	गुमान	गुमान
gulshan	गुलशान	गुलशन
gunga	गुंगा	गूंगा
grihnagar	गृहनगर	गृहनगर
gruhnagar	गृहनगर	गृहनगर
galaxion	गलक्सियन	गैलेक्सियों
galaxiyon	गलक्सियों	गैलेक्सियों
galaxyon	गलक्सियों	गैलेक्सियों
gochar	गोचार	गोचर
gouchar	गौचर	गोचर
godara	गोड़ा	गोदारा
gopichand	गोपिचंद	गोपीचंद
gomake	गोमेक	गोमके
gomke	गोमके	गोमके
goel	गोल	गोयल
goyal	गोयल	गोयल
gosvaami	गोस्वामी	गोस्वामी
gosvami	गोस्वामी	गोस्वामी
goswami	गोस्वामी	गोस्वामी
gaumukh	गौमुख	गौमुख
gomukh	गोमुख	गौमुख
gaumutr	गौमुत्र	गौमूत्र
gaumutra	गौमुत्र	गौमूत्र
gowmutra	गोमोत्र	गौमूत्र
granthiyaan	ग्रांथियां	ग्रंथियां
granthiyan	ग्रांथियां	ग्रंथियां
grandhiyon	ग्रांधियों	ग्रंथियों
granthiyon	ग्रांथियों	ग्रंथियों
greest	ग्रीस्ट	ग्रीस्ट
greist	ग्रेस्ट	ग्रीस्ट
grist	ग्रिस्ट	ग्रीस्ट
greg	ग्रेज	ग्रेग
granite	ग्रेनेटी	ग्रेनाइट
grenite	ग्रेनेट	ग्रेनाइट
grandson	ग्रेंडों	ग्रैंडसन
gross	ग्रोस	ग्रॉस
ghataatop	घटातोप	घटाटोप
ghatatop	घटातोप	घटाटोप
ghataayaa	घटाया	घटाया
ghataya	घटाया	घटाया
ghanakar	घनकर	घनाकार
ghabrahat	घबराहत	घबराहट
ghasi	घासी	घासी
ghisai	घिसाई	घिसाई
ghisi	घिसी	घिसी
ghise	घीसे	घिसे
ghumakkadi	घुमककादी	घुमक्कड़ी
ghumakkdi	घुमकक्दी	घुमक्कड़ी
ghumakkadon	घुमककादों	घुमक्कड़ों
ghumakkaron	घुमककारों	घुमक्कड़ों
ghumakkdon	घुमकक्दों	घुमक्कड़ों
ghummakkadon	घुम्मकादों	घुमक्कड़ों
ghumaan	घुमान	घुमाण
ghuman	घुमान	घुमाण
ghoonsa	घूंसा	घूंसा
ghunsa	घुंसा	घूंसा
ghongha	घोंघा	घोंघा
ghontane	घोंटने	घोंटने
ghontne	घोंटने	घोंटने
ghot	घोत	घोट
ghodi	घोडी	घोड़ी
ghost	घोस्त	घोस्ट
changul	चंगुल	चंगुल
chand	चांड	चंद
chandan	चंदन	चंदन
chandana	चंडना	चंदन
chandu	चंदु	चंदू
chandon	चंदों	चंदों
chandrabali	चंद्रबाली	चंद्रबली
chandramaon	चंदरमाओं	चंद्रमाओं
chakatte	चकतते	चकत्ते
chaktte	चक्तते	चकत्ते
chakkar	चकककर	चक्कर
chkkar	चककार	चक्कर
chakshu	चक्षु	चक्षु
chatagaon	चटागाओं	चटगांव
chatgaon	चटगां	चटगांव
chadhane	चढ़ने	चढ़ने
chadhne	चढ़ने	चढ़ने
chaturdik	चतुर्दिक	चतुर्दिक
chatunshkoniy	चतुंक्षियों	चतुष्कोणीय
chatushkoniy	चतुसककियां	चतुष्कोणीय
chatushkoniya	चतुस्कियाई	चतुष्कोणीय
channa	चन्ना	चन्ना
chabate	चबते	चबाते
chabutare	चबुतेरे	चबूतरे
chabutre	चबुत्ेे	चबूतरे
chamakna	चमकाना	चमकना
chamkana	चमकाना	चमकना
charas	चररस	चरस
charit	चरित	चरित
charcha	चर्चा	चर्चा
churcha	चर्चा	चर्चा
charchaon	चर्चाओं	चर्चाओं
chalenge	चलेंगे	चलेंगे
chlenge	क्लेंगे	चलेंगे
chahunaur	चहुनुरा	चहुंओर
chahunor	चाहुनोर	चहुंओर
chanval	चंवल	चांवल
chanwal	चंवल	चांवल
chachaji	चचाजी	चाचाजी
chadar	चादार	चादर
chadaron	चादारों	चादरों
chadron	चाद्रों	चादरों
chan	चैन	चान
chanan	चनन	चानन
chaplusi	चापसुली	चापलूसी
chayal	चयाल	चायल
char	चार	चार
charon	चरों	चारों
charge	चर्ज	चार्ज
chart	चर्त	चार्ट
charton	चर्टों	चार्टों
charts	चा््ट्स	चार्ट्स
chaalit	चालित	चालित
chalit	चलित	चालित
chikitsak	चिकित्सक	चिकित्सक
chikitsakon	चिकिस्तकों	चिकित्सकों
chikhali	चिखली	चिखली
chiththi	चिथती	चिट्ठी
chitthi	चित्थी	चिट्ठी
chithhi	चिथी	चिठ्ठी
chiththi	चिथती	चिठ्ठी
chitthi	चित्थी	चिठ्ठी
chidchidapan	चिड़चिड़ापन	चिडचिडापन
chidchidapan	चिड़चिड़ापन	चिड़चिड़ापन
chidhate	चिढ़ते	चिढ़ते
chidhte	चिढ़ते	चिढ़ते
chithrkar	चित्रकार	चित्रकार
chitrkar	चित्रकार	चित्रकार
chipakane	चिपकाने	चिपकने
chipakne	चिपकने	चिपकने
chipkane	चिपकने	चिपकने
chimati	चिमती	चिमटी
chimti	चिमती	चिमटी
chillane	चिललने	चिल्लाने
chee	ची	ची
chi	ची	ची
chuka	चुका	चुका
chune	चुने	चुने
chunar	चुनर	चूनर
changed	चैंगेड	चेंज्ड
chetti	चेत्ती	चेट्टी
chennai	चेनाई	चेन्नई
chero	चेरो	चेरो
chest	चेस्ट	चेस्ट
championship	चंपीशिप	चैंपियनशिप
chor	चोर	चोर
choro	चोरो	चोरों
choron	चोरों	चोरों
chauk	चौक	चौक
chowk	चॉक	चौक
chauka	चौका	चौका
chuka	चुका	चौका
chaukiyan	चौकियां	चौकियां
chauki	चौकी	चौकी
chaukhate	चौखते	चौखटे
chauguni	चौगुनी	चौगुनी
chauda	चौदा	चौड़ा
chaudah	चौदाह	चौड़ा
chaudahavan	चौदहवान	चौदहवां
chaudhavan	चौदहवान	चौदहवां
chaudhawan	चौधावन	चौदहवां
chaupati	चौपती	चौपाटी
chupaty	चुपटी	चौपाटी
chaupal	चौपल	चौपाल
chaurai	चौराई	चौरई
chausinga	चौसिंगा	चौसिंगा
chausingha	चौसिंहा	चौसिंगा
chhagan	छागन	छगन
chhabi	छाबी	छबि
chhalla	छल्ला	छल्ला
chhallaa	छलला	छल्ला
chhaviyaan	छवियां	छवियाँ
chhaviyan	छवियां	छवियाँ
chhavi	छावी	छवी
cheh	चेह	छह
chhah	छा	छह
chehon	चेहों	छहों
chhahon	छाहों	छहों
chhai	छाई	छाई
chhagla	छगला	छागला
chhajan	छाजन	छाजन
chhaati	छाती	छाती
chhati	छती	छाती
chhaapemaar	छापेमार	छापेमार
chhapemar	छेपेमर	छापेमार
chheenk	छींक	छींक
chhink	छिंक	छींक
chink	चिंक	छींक
chenkein	चेंकें	छींके
chhekein	छेकें	छींके
chhinke	छिंके	छींके
chhinky	छिंकी	छींके
chinke	चिंके	छींके
chhudaane	छुड़ने	छुडाने
chhudane	छुड़ने	छुडाने
chhupakar	छुपककर	छुपकर
chhupkar	छुपककर	छुपकर
chhupkr	छुपकर	छुपकर
chhupata	छुपटा	छुपता
chhupta	छुप्टा	छुपता
chhuptaa	छुप्टा	छुपता
chhura	छुरा	छुरा
chhuraa	छुरा	छुरा
chhuree	छुरी	छुरी
chhuri	छुरी	छुरी
chhure	छुरे	छुरे
chhootane	छूटने	छूटने
chhutane	छुटाने	छूटने
chhutne	छुट्ने	छूटने
chheter	छेत्र	छेत्र
chhetr	छेत्र	छेत्र
chhetter	छेत्तर	छेत्र
chhetri	छेत्री	छेत्री
chhetthari	छेत्तरही	छेत्री
chhetthri	छेत्तरी	छेत्री
chai	चाई	छै
chhai	छाई	छै
chhe	छे	छै
jagaega	जगागगा	जगाएगा
jagayega	जगाएगा	जगाएगा
jaghaega	जगाएगा	जगाएगा
jgaayega	जगाएगा	जगाएगा
jgayegaa	जगाएगा	जगाएगा
jajaon	जजाओं	जजों
jajon	जाजों	जजों
jad	जाद	जड़
jadd	जद्द	जड़
jaddit	जददीत	जड़ित
jadeite	जाड़ते	जड़ित
jadet	जादेत	जड़ित
jadit	जादित	जड़ित
jadein	जादें	जड़ें
jaden	जादें	जड़ें
jatara	जतररा	जतरा
jatra	जतर्	जतरा
jataati	जताती	जताती
jatatee	जततती	जताती
jatati	जतती	जताती
janagananaa	जनानगनन	जनगणना
janaganna	जनांगना	जनगणना
jangadnaa	जंगदाना	जनगणना
janganana	जनगानना	जनगणना
janganna	जनगननना	जनगणना
janajagran	जनजाग्रण	जनजागरण
janjaagran	जनजाग्रण	जनजागरण
janjagran	जनजगगरण	जनजागरण
january	जनुरीय	जनवरी
janahaani	जनहानी	जनहानि
janahani	जनहानी	जनहानि
janhaani	जनहानी	जनहानि
janhani	जनहहीन	जनहानि
jnhaani	जनहानी	जनहानि
jamaate	जमाते	जमाती
jamaati	जमाती	जमाती
jamati	जमती	जमाती
jamaaya	जमाया	जमाया
jamaeya	जमाए	जमाया
jamaya	जमाया	जमाया
jamayaa	जमाया	जमाया
jamuai	जमुई	जमुई
jamuei	जमुई	जमुई
jamui	जमूी	जमुई
jai	जाई	जय
jay	जाय	जय
jaidayal	जैदाल	जयदयाल
jayadayal	जयादाल	जयदयाल
jaydayal	जयदालय	जयदयाल
jaibaan	जैबान	जयबाण
jaiban	जैबन	जयबाण
jaybaan	जयबनन	जयबाण
jayalalita	जयललिता	जयललिता
jayalalitaa	जयललिता	जयललिता
jayalalithaa	जयललिता	जयललिता
jaylalita	जाललिता	जयललिता
jarakh	जरखख	जरख
zarakh	जरखख	जरख
jarda	जर्दा	जर्दा
jardaa	जरदा	जर्दा
zarda	जर्दा	जर्दा
jalagati	जलगगती	जलगति
jalgati	जलगगती	जलगति
jalgti	जलगती	जलगति
jalte	जलते	जलते
jalbharav	जलभारव	जलभराव
jalbhraav	जलभर्व	जलभराव
jalbhrav	जलभर्व	जलभराव
jalvaayu	जलवायु	जलवायु
jalvayu	जलवायु	जलवायु
jalesar	जलेसर	जलेसर
jasmeet	जसममत	जसमीत
jasmit	जसममत	जसमीत
jassee	जससी	जस्सी
jassi	जससी	जस्सी
jamaanaa	जमाना	ज़माना
jamana	जमाना	ज़माना
zamaanaa	जमाना	ज़माना
zamana	जमाना	ज़माना
jaljale	जलजले	ज़लज़ले
zalzale	जलजलले	ज़लज़ले
zee	जी	ज़ी
jubaan	जुबान	ज़ुबान
juban	जुबान	ज़ुबान
zuban	जुबन	ज़ुबान
jaanch	जांच	जाँच
jaaunch	जांच	जाँच
janch	जांच	जाँच
jaunch	जांच	जाँच
jaagriti	जाग्तीी	जागृति
jagriti	जगगीती	जागृति
jagruti	जगगृति	जागृति
jajamau	जजमाऊ	जाजमऊ
jajmau	जजमाऊ	जाजमऊ
jajmauu	जजमूऊ	जाजमऊ
jaat	जात	जात
jat	जात	जात
jaatak	जातक	जातक
jatak	जतक	जातक
jaatakon	जातकों	जातकों
jaatkon	जातकों	जातकों
jatakon	जतककों	जातकों
jaatiyon	जातियों	जातियों
jatiyon	जातियों	जातियों
jaankaaron	जानकररों	जानकारों
jaankaron	जानकरों	जानकारों
jankaron	जनकारों	जानकारों
jaanam	जानम	जानम
janam	जन्म	जानम
jaayke	जायके	जायके
jayke	जायके	जायके
jaawar	जावर	जावर
zawar	जवार	जावर
jing	जिंग	जिंग
gin	गीन	जिन
jeen	जीन	जिन
jin	जीन	जिन
ginee	गिनी	जिनी
jinee	जिनी	जिनी
jini	जिनी	जिनी
geneva	जेनेवा	जिनीवा
jeneva	जेनेवा	जिनीवा
jiniva	जीनिवा	जिनीवा
gypsy	जिप्सी	जिप्सी
jimme	जिम्मे	जिम्मे
jiya	जिया	जिया
gic	जीसीी	जीआईसी
gr	गीर	जीआर
gm	जीएम	जीएम
gsm	एगएसएम	जीएसएम
gtod	ग्टोड	जीतोड़
gtor	ग्टोर	जीतोड़
jeetod	जीतोड़	जीतोड़
jitod	जितोड	जीतोड़
jean	जीन	जीन
jeen	जीन	जीन
jin	जीन	जीन
jeenon	जीनों	जीनों
jinon	जिनों	जीनों
jeepney	जीपने	जीपनी
jipani	जीपनी	जीपनी
jeeyo	जीयो	जीयो
jio	जाइ	जीयो
jiyo	जियो	जीयो
jeera	जीरा	जीरा
jira	जिरा	जीरा
jeevant	जीवंत	जीवंत
jivant	जीवंत	जीवंत
jeevan	जीवन	जीवन
jeewan	जीवन	जीवन
jivan	जीवन	जीवन
jiwan	जीवन	जीवन
jeevanshaili	जीवनशाली	जीवनशैली
jivanshaili	जीवनशाली	जीवनशैली
jeevniyaan	जीवनियां	जीवनियां
jivaniya	जीवनीय	जीवनियां
jivaniyaan	जीवनियां	जीवनियां
jivaniyan	जीवनियां	जीवनियां
jeevraaj	जीवराज	जीवराज
jivraj	जिवर्ज	जीवराज
jua	जुआ	जुए
jue	जू	जुए
juye	जुए	जुए
jutee	जुटी	जुटी
juti	जूटी	जुटी
judaai	जुडाई	जुड़ाई
judae	जुड़ा	जुड़ाई
judai	जुडाई	जुड़ाई
judaai	जुडाई	जुदाई
judai	जुडाई	जुदाई
junoon	जूनून	जुनून
junun	जूनून	जुनून
junooni	जूनूनी	जुनूनी
jununi	जुनूनी	जुनूनी
jubair	जुबार	जुबेर
juber	जुबर	जुबेर
zubair	जुबार	जुबेर
juraab	जुराब	जुराब
jurab	जुरब	जुराब
julaahon	जुलाहों	जुलाहों
julahon	जुलाहों	जुलाहों
julmon	जुलमों	जुल्मों
zulmon	लुम्मों	जुल्मों
jood	जूड	जूड
jud	जुड	जूड
junagadh	जुनागढ़	जूनागढ
junagarh	जुनागढ़	जूनागढ
junior	जुनियर	जूनियर
jealous	जेलोस	जूलूस
juloos	जुलूस	जूलूस
julus	जुलूस	जूलूस
jetha	जेठा	जेठा
jenner	जेनर	जेनर
generic	जेनरिक	जेनरिक
jenrick	जेनरिकक	जेनरिक
generat	जेनरेट	जेनरेट
generate	जनरेटे	जेनरेट
jenee	जीनी	जेनी
jenni	जेनी	जेनी
jenny	जेनी	जेनी
james	जमेस	जेम्स
jeremy	जेर्मी	जेरेमी
gerome	जर्मो	जेरोम
jerome	जर्मो	जेरोम
jacks	जैक्स	जैक्स
jain	जैन	जैन
gene	जेने	जैने
jaine	जाएं	जैने
jaino	जैनो	जैनों
jainon	जानों	जैनों
jerry	जेरी	जैरी
jasper	जसपर	जैस्पर
jogging	जोगिंगग	जॉगिंग
johnson	जॉनसन	जॉनसन
jobs	जॉब्स	जॉब्स
jockey	जॉकी	जोकि
joki	जोकी	जोकि
jokhim	जोखिम	जोखिम
joddta	जोड़ता	जोड़ता
jodta	जोड़ता	जोड़ता
jorhta	जोर्ता	जोड़ता
jodiyon	जोड़ियों	जोड़ियों
jodo	जोड़	जोड़ो
jaun	जाउन	जौं
gyatavya	ज्ञात्य	ज्ञातव्य
gyatvy	ज्ञात्य	ज्ञातव्य
gyapit	ज्ञापित	ज्ञापित
jyotiba	ज्योतिबा	ज्योतिबा
joint	जोइंट	ज्वाइंट
jvar	ज्वर	ज्वार
jwar	जवार	ज्वार
jvaaron	ज्वारों	ज्वारों
jvaron	ज्वारों	ज्वारों
jwaron	जवारों	ज्वारों
jewellers	ज्वेलर्स	ज्वेलर्स
jh	झे	झ
jha	झा	झ
jhalakti	झलकती	झलकती
jhalkati	झलकती	झलकती
jhalla	झलला	झल्ला
jhankana	झंकाना	झांकना
jhankna	झंकना	झांकना
jheel	झील	झील
jhil	झील	झील
jheelon	झीलों	झीलों
jhilon	झिलों	झीलों
jhuthala	झुठला	झुठला
jhuthla	झूठला	झुठला
jhuthalane	झुठलाने	झुठलाने
jhuthlane	झुठलाने	झुठलाने
tankaar	टंकार	टंकार
tankar	टंकर	टंकार
takara	ताकरा	टकरा
takra	तकरा	टकरा
takaraon	टाकाराओं	टकरावों
takravon	तकरववों	टकरावों
tapakti	तपक्ति	टपकती
tapkati	तपकती	टपकती
time	टाइम	टाइम
timer	टाइमर	टाइमर
taoo	ताओ	टाऊ
tau	तौऊ	टाऊ
tapoowo	तपूवू	टापुओं
tapuon	तापूओं	टापुओं
tapuwo	तपपूवो	टापुओं
tied	ताइड	टायर्ड
tired	टीरेड	टायर्ड
tyred	टायर्ड	टायर्ड
tarch	तर्च	टार्च
torch	टॉर्च	टार्च
tik	टीक	टिक
teap	टीप	टिप
tip	टीपपी	टिप
tippanikar	तिप्पणिकार	टिप्पणीकार
tippnikar	तिप्नीकरर	टिप्पणीकार
tivolee	तिवोली	टिवोली
tivoli	तिवोली	टिवोली
teekamgarh	तीकागढ़	टीकमगढ़
tikamgarh	टीकागगढ़	टीकमगढ़
teekon	टीकों	टीकों
tikon	टीकों	टीकों
two	ट्वो	टु
tension	टेंसन	टेंशन
tenis	टेनिस	टेनिस
tennis	टेनिस	टेनिस
taste	तस्ते	टेस्ट
test	टेस्ट	टेस्ट
tasting	टस्टिंग	टेस्टिंग
testing	टेस्टिंग	टेस्टिंग
tainin	तैनीन	टैनिन
tenin	तेनीन	टैनिन
tanish	तानीश	टैनिस
tennis	टेनिस	टैनिस
taboo	ताबू	टैबू
taiboo	तैबू	टैबू
taobao	ताबोो	टैबू
tonic	टॉनिक	टॉनिक
tonga	टोंगा	टोंगा
toka	टोका	टोका
tuesday	टुसेडे	ट्यूजडे
tuning	ट्यूंग	ट्यूनिंग
tuberculosis	टब्रूस्सोसिस	ट्यूबरक्यूलोसिस
tuberkyulosis	टब्बुक्सिल्स	ट्यूबरक्यूलोसिस
truck	ट्रिक	ट्रक
trangistor	ट्रेंगिटर्स	ट्रांजिस्टर
tranjister	ट्रांजीसटर	ट्रांजिस्टर
transistor	ट्रांसिस्टर	ट्रांजिस्टर
transfer	ट्रांसफर	ट्रान्सफर
tribunal	त्रिबुलन	ट्रिब्युनल
tribunal	त्रिबुलन	ट्रिब्यूनल
trubyunal	त्रिबुनल	ट्रिब्यूनल
truth	त्रुठ	ट्रुथ
tuth	तथ	ट्रुथ
traded	ट्रेडेड	ट्रेडेड
trabal	ट्रबल	ट्रेबल
trebal	ट्रेबल	ट्रेबल
trouble	ट्रॉबल	ट्रेबल
traip	ट्रेप	ट्रैप
trap	त्राप	ट्रैप
trot	ट्रोट	ट्रॉट
trott	ट्रोट्ट	ट्रॉट
thakkar	ठक्कर	ठक्कर
thakkr	ठक्कर	ठक्कर
thaharne	ठहराने	ठहरने
thahrane	ठहराने	ठहरने
theharne	ठहरेन	ठहरने
thikane	ठिकने	ठिकाने
thumari	थुमरी	ठुमरी
thumri	थुमरी	ठुमरी
theinga	थींगा	ठेंगा
thenga	ठेंगा	ठेंगा
thengaa	ठेंगा	ठेंगा
daglas	दगलस	डगलस
douglas	डॉगलस	डगलस
dabhara	दाभरा	डभरा
dabhra	दाभरा	डभरा
dabhoi	दाभोई	डभोई
dam	डम	डम
dum	डू	डम
darate	दरते	डराते
daratey	दरते	डराते
daravani	दरवानी	डरावनी
darawani	दरवानी	डरावनी
dravani	द्रवानी	डरावनी
down	डॉन	डाउन
daak	दाक	डाक
dak	डक	डाक
daka	डका	डाका
dabi	दबी	डाबी
dabolim	दबलियम	डाबोलिम
dinosaur	डियोनरर	डायनासोर
diaries	डायरिज	डायरीज
dit	दीत	डिट
depthiriya	देप्थिरिया	डिप्थीरिया
diphtheria	दिफ्तिरिया	डिप्थीरिया
de	दे	डीई
dealership	देरलिप्प	डीलरशिप
dvc	डीवीसी	डीवीसी
dubaana	दुबाना	डुबाना
dubana	दुबाना	डुबाना
dubona	दूबनो	डुबोना
dulne	दुलने	डुलने
doonarpur	दूनपरपुर	डूंगरपुर
doongarpur	दूनगपपुर	डूंगरपुर
dungarpur	दुंगपुर	डूंगरपुर
dungerpur	डुंपररर	डूंगरपुर
dubana	दुबाना	डूबना
dubna	दूबना	डूबना
dangerous	डैंगरर	डेंजरस
daisy	डैसी	डेजी
dazy	देज्य	डेजी
deji	देजी	डेजी
deputy	डिप्टी	डेप्युटी
davidson	दाविसन	डेविडसन
devidson	दीवेडन	डेविडसन
davey	देवे	डेवी
devi	देवी	डेवी
dewey	देवे	डेवी
destination	डेस्टिशनन	डेस्टिनेशन
datson	दत्सों	डैटसन
datsun	दतसुन	डैटसन
daddy	दद्दीय	डैडी
dark	डर्क	डॉर्क
dork	डोर्क	डॉर्क
dose	डोसे	डोज
domenic	डोमेनिक	डोमेनिक
doranda	दोरंडा	डोरंडा
dolane	डोलने	डोलने
dolne	डोलने	डोलने
dual	दुआल	ड्युअल
duak	दुक	ड्यूक
duke	डुके	ड्यूक
drame	ड्रेम	ड्रामे
dramen	ड्रेमन	ड्रामे
drager	ड्रेजर	ड्रेजर
dredger	ड्रेजर	ड्रेजर
dreijer	ड्रेजर	ड्रेजर
dhakaal	ढकाल	ढकाल
dhakal	ढकल	ढकाल
dhakkal	धक्कल	ढकाल
dhkal	ढकल	ढकाल
dhale	ढाले	ढले
dhoondh	ढूंध	ढूंढ
dhundh	ढुंध	ढूंढ
dhoondhata	ढूंधता	ढूंढता
dhundhata	ढुंधता	ढूंढता
dhundhta	ढुंधता	ढूंढता
dhoondhi	ढूंधी	ढूंढी
dhundhi	ढुंधी	ढूंढी
tanjavur	तंजवूर	तंजावुर
thanjavur	ठंजवहुर	तंजावुर
tantr	टंत्र	तंत्र
tantra	तंत्र	तंत्र
tantrikao	तंत्रिकाओं	तंत्रिकाओं
tantrikaon	तंत्रिकाओं	तंत्रिकाओं
tantro	टंत्रों	तंत्रों
tantron	तंत्रों	तंत्रों
tagade	टाड़े	तगड़े
tagde	तगड़े	तगड़े
tadipaar	तापीदार	तड़ीपार
tadipar	तापीदार	तड़ीपार
tani	तानी	तनी
tapan	तपन	तपन
tarafa	तरफा	तरफा
tarfa	तरफा	तरफा
tarabganj	तररबंगज	तरबगंज
taras	तरसस	तरस
taraash	तरराश	तराश
tarash	तररशश	तराश
tarashay	तराशय	तराशे
tarashe	तररशे	तराशे
tareeko	तारीको	तरीको
tariko	तारीको	तरीको
tark	तर्क	तर्क
tarkvaad	तर्कवाद	तर्कवाद
tarkvad	तर्कवाद	तर्कवाद
tarkwaad	तर्कवाद	तर्कवाद
tarko	तार्को	तर्कों
tarkon	तरकों	तर्कों
talabgaar	तलागबार	तलबगार
talabgar	तलाबगगर	तलबगार
talbagaar	तलबगगार	तलबगार
talbagar	तलबगगार	तलबगार
talawe	तलवे	तलवे
talve	तलवे	तलवे
talawon	तलवों	तलवों
talvon	तलवों	तलवों
tahakhana	तहखाना	तहखाना
tahkhaana	तहहकान	तहखाना
tahkhana	तहखाना	तहखाना
taantaa	तांता	तांता
tanta	टांटा	तांता
tambe	तंबे	तांबे
tanbe	तांबे	तांबे
taaja	ताजा	ताजा
taajaa	ताजा	ताजा
taaza	ताज़ा	ताजा
taja	ताजा	ताजा
taza	ताजा	ताजा
tansen	टांसें	तानसेन
taapmaanon	तापमानों	तापमानों
tapmano	तपमानों	तापमानों
tapmanon	तपमानों	तापमानों
taapti	तापती	ताप्ती
tapti	तप्ती	ताप्ती
tarabai	तरबाई	ताराबाई
taseer	तसीर	तासीर
tasir	तासीर	तासीर
taahi	ताही	ताहि
tahi	तहही	ताहि
tikone	टीकोन	तिकोने
tirupati	तिरुपति	तिरूपति
tiwari	तिवारी	तिवारी
ti	ती	ती
teer	तीर	तीर
tir	तीर	तीर
teeron	तीरों	तीरों
tiron	तीरों	तीरों
tirthatan	तीर्थान	तीर्थाटन
tungnath	तुनगनगथ	तुंगनाथ
tughlaq	तुगला	तुगलक
tuglak	तुगलक	तुगलक
tughlakabad	तुगलबादाद	तुगलकाबाद
tughlaqabad	तुगलबादाद	तुगलकाबाद
tuglakabad	तुगलबादाद	तुगलकाबाद
tugalaki	तुगलाकी	तुगलकी
tugalki	तुगगली	तुगलकी
tuglaki	तुगलकी	तुगलकी
tufail	टफफलल	तुफैल
tejaji	तेजाजी	तेजाजी
teji	तेजी	तेजी
tel	टेल	तेल
telon	टेलों	तेलों
to	टो	तो
toh	तोह	तो
taul	तौल	तौल
tyohaar	त्योहार	त्यौहार
tyohar	त्योहर	त्यौहार
tyoihar	त्योहिर	त्यौहार
tyauharon	त्याहौरों	त्यौहारों
tyoharon	त्योहरों	त्यौहारों
tyoiharon	त्योहिरों	त्यौहारों
trijata	त्रिजता	त्रिजटा
trijta	त्रिजता	त्रिजटा
triya	त्रिया	त्रिया
tremasik	त्रेमासिक	त्रैमासिक
trimasik	त्रिमासिक	त्रैमासिक
tse	टेस	त्से
thaki	ठकी	थकी
thki	थकी	थकी
tharti	थरती	थर्टी
thirty	थिर्टी	थर्टी
thane	थाने	थाणे
thaanvi	थानवी	थानवी
thanvi	थनवी	थानवी
theateron	थीतरों	थिएटरों
theatron	थीत्रों	थिएटरों
theaters	थीटर्स	थिएटर्स
theater	थीतर	थियेटर
theatre	थीत्रे	थियेटर
theateron	थीतरों	थियेटरों
theatron	थीत्रों	थियेटरों
thitron	थित्रों	थियेटरों
theaters	थीटर्स	थियेटर्स
theatrs	थीट््स	थियेटर्स
thiyeters	थियेटर्स	थियेटर्स
thirake	थिरके	थिरके
thirke	थिरके	थिरके
thief	थीफ	थीफ
then	थें	थेन
theni	थेनी	थेनी
thailee	थाली	थैली
thaili	थाली	थैली
thaile	थाले	थैले
dang	डंंग	दंग
danga	डंगा	दंगा
dangon	डंंगों	दंगों
dampati	दंपपती	दंपति
danpati	दंपती	दंपति
dampatiyon	दंपतियों	दंपतियों
dampattiyon	दंपततियों	दंपतियों
danptiyon	दंपतियों	दंपतियों
dadreva	ददरेवा	ददरेवा
dadrewa	दारेवा	ददरेवा
damoh	दमोह	दमोह
dardara	दरदारा	दरदरा
dardraa	दर्दरा	दरदरा
durdhara	दूर्धा	दरदरा
darmiyaan	दरमियां	दरमियान
darmiyan	दरमियां	दरमियान
darjano	दरजानों	दर्जनों
darjanon	दरजानों	दर्जनों
darp	दर्प	दर्प
darra	दररा	दर्रा
dalbadal	दलबाडल	दलबदल
dalbadl	डलबडल	दलबदल
dali	डाली	दली
dastaanaa	दस्ताना	दस्ताना
dastana	दस्तना	दस्ताना
dastavej	दस्तवेज	दस्तावेज
dahan	दहन	दहन
dahal	दहाल	दहल
da	दा	दा
daakhil	दाखील	दाखिल
dakhil	दखीी	दाखिल
daakhile	दाखीले	दाखिले
dakhile	दखखीले	दाखिले
daataa	दाता	दाता
data	दता	दाता
dadari	दादारी	दादरी
daanshil	दानशील	दानशील
danshil	दंशील	दानशील
daabholkar	दाभोलकर	दाभोलकर
dabholkar	दाभलोकर	दाभोलकर
damale	दमले	दामले
damle	डमले	दामले
dayitv	दायतवव	दायित्व
dayitva	दायतवव	दायित्व
dayitwa	दायतववा	दायित्व
dayitvon	दायतववों	दायित्वों
dayityon	दायितों	दायित्वों
darul	दररूल	दारूल
daav	दाव	दाव
daaw	दाव	दाव
dav	दाव	दाव
daw	दाव	दाव
daah	दाह	दाह
dah	दहह	दाह
dikhla	दिखला	दिखला
dikhlaa	दिखला	दिखला
dikhaaiye	दिखाए	दिखाइये
dikhaiye	दिखाए	दिखाइये
dikhaai	दिखाई	दिखाई
dikhai	दिखाई	दिखाई
dikhayi	दिखाई	दिखाई
dikhaaee	दिखाई	दिखाईं
dikhaai	दिखाई	दिखाईं
dikhaain	दिखाएं	दिखाईं
dikhaee	दिखाई	दिखाईं
dikhai	दिखाई	दिखाईं
dikhayin	दिखाएं	दिखाईं
dikhai	दिखाई	दिखायी
dikhayi	दिखाई	दिखायी
dikhaai	दिखाई	दिखार्इ
dikhae	दिखाए	दिखार्इ
dikhai	दिखाई	दिखार्इ
dikhayi	दिखाई	दिखार्इ
dita	दीता	दिता
ditaa	दीता	दिता
dinaank	दीनांक	दिनांक
dinank	दीनांक	दिनांक
dirham	दीरहम	दिरहम
dilaaye	दिलाए	दिलाये
dilaye	दिलाए	दिलाये
deewani	दीवानी	दिवानी
diwani	दीवानी	दिवानी
divy	दीवी	दिव्य
divya	दिव्या	दिव्य
divyata	दिव्यता	दिव्यता
divya	दिव्या	दिव्या
deepan	दीपन	दीपन
deepn	दीपन	दीपन
dipan	दीपन	दीपन
deepsingh	दीपिंह	दीपसिंह
dipsingh	डिपिंग	दीपसिंह
deepika	दीपिका	दीपिका
dipika	दीपिका	दीपिका
deeya	दीया	दीया
diya	दिया	दीया
dukaanon	दुकानों	दुकानों
dukanon	दुकानों	दुकानों
dukke	दुक्के	दुक्के
dukhan	दुखन	दुखन
dukhit	दुखित	दुखित
dukhiyon	दुखियों	दुखियों
dukhon	दूखों	दुखों
dubhashiyon	दुभाषियों	दुभाषियों
durgun	दुर्गुन	दुर्गुण
durghatna	दुर्घटना	दुर्घटना
durghtna	दुर्घटना	दुर्घटना
duneerti	दुनरीती	दुर्नीति
durniti	दूर्णिति	दुर्नीति
durbhiksh	दुर्भिक्ष	दुर्भिक्ष
duvidhaaen	दुविधाएं	दुविधाएं
duvidhaayein	दुविधाएं	दुविधाएं
duvidhaen	दुविधाएं	दुविधाएं
duwaidhaayein	दुवेधाएं	दुविधाएं
dune	दूने	दूने
doordarshan	दूरदर्शन	दूरदर्शन
durdarshan	दूरदर्शन	दूरदर्शन
dradh	द्राध	दृढ़
dridh	द्रिध	दृढ़
dekhoge	देखेगे	देखोगे
denevaali	देनवाली	देनेवाली
denevali	देनेवाली	देनेवाली
denewaali	देनेवाली	देनेवाली
denewali	देनेवाली	देनेवाली
deonar	देनार	देवनार
devnaar	देवनार	देवनार
devnar	देवनार	देवनार
devaapur	देवापुर	देवापुर
devapur	देवापुर	देवापुर
devi	देवी	देवी
devisingh	देविसिंह	देवीसिंह
devisinh	देविसिन	देवीसिंह
deshkaal	देशकाल	देशकाल
deshkal	देशकल	देशकाल
deshke	देशके	देशके
desai	देसाई	देसाई
doge	डोगे	दोगे
dvadash	द्वादाश	द्वादश
dwaadas	द्वादास	द्वादश
dvivedi	द्विदेवी	द्विवेदी
dwivedi	द्विवेदी	द्विवेदी
dhande	ढांडे	धंधे
dhandhe	ढांधे	धंधे
dhndhe	धन्धे	धंधे
dhandhon	ढंधों	धंधों
dhandon	ढंडों	धंधों
dhakelte	ढकेलते	धकेलते
dhkelate	ढकेलते	धकेलते
dhatana	धटना	धटना
dhatna	धटना	धटना
dhankuber	धनकुबेर	धनकुबेर
dhanadhany	धनांधीय	धनधान्य
dhandhaanya	ढंधनयय	धनधान्य
dhandhany	ढनंधीय	धनधान्य
dhandhanya	ढंधनयय	धनधान्य
dhamkaataa	धमकाता	धमकाता
dhamkata	धमकता	धमकाता
dhamm	धम्म	धम्म
dhamma	धम्म	धम्मा
dhammaa	धममा	धम्मा
dharmnath	धर्मनाथ	धर्मनाथ
dharmraj	धर्माज	धर्मराज
dharmesh	धर्मेश	धर्मेश
dhasmaanaa	धसममाना	धस्माना
dhasmana	धसममान	धस्माना
dhaak	धाक	धाक
dhak	ढक	धाक
dhaaga	ढागा	धागा
dhaagaa	धागा	धागा
dhaga	ढागा	धागा
dhaatuein	धातुएं	धातुएं
dhaatuyein	धातुएं	धातुएं
dhtuen	ध्तूएं	धातुएं
dhaarak	धारक	धारक
dharak	धररक	धारक
dhaari	धारी	धारी
dhari	धारी	धारी
dhuan	धुन	धुआं
dhunaai	धुनाई	धुनाई
dhunai	धुनाई	धुनाई
dhuriya	धुरिया	धुरिया
dhuriyaa	धुरिया	धुरिया
dhuni	धूनी	धूनी
dhairyavaan	धैर्यवान	धैर्यवान
dhairyawan	धैर्यवान	धैर्यवान
dhiryavan	धीर्यावन	धैर्यवान
dhiryawaan	धीर्यवान	धैर्यवान
dhokebaaj	धोकेबाज	धोखेबाज
dhokebaaz	धोकेबाज	धोखेबाज
dhokebaj	धोकेबाज	धोखेबाज
dhokebaz	धोकेबाज	धोखेबाज
dhokhebaaj	धोखेबाज	धोखेबाज
dhokhebaj	धोखेबाज	धोखेबाज
dhona	ढोना	धोना
dhonaa	धोना	धोना
dhoraaji	धोराजी	धोराजी
dhoraji	धोराजी	धोराजी
dhoron	धोरों	धोरों
dhyeyavaadi	ध्यावादी	ध्येयवादी
dhyeywadi	ध्यावेदी	ध्येयवादी
dyeyvadi	दायवादी	ध्येयवादी
dhrupad	ध्रुपद	ध्रुपद
drupad	द्रुपद	ध्रुपद
nandanvan	नंदवान	नंदनवन
nadsa	नादसा	नक्सल
naksal	नकसाल	नक्सल
naxal	नसकल	नक्सल
naksalavaad	नक्सलवाद	नक्सलवाद
naksalwaad	नक्सवलाद	नक्सलवाद
naksalwad	नक्सलवाद	नक्सलवाद
naxalvaaad	नक्सलवाद	नक्सलवाद
naxalwaad	नक्सवलाद	नक्सलवाद
naksaliyon	नकसालियों	नक्सलियों
naxaliyon	नसकालियों	नक्सलियों
naksali	नकसाली	नक्सली
naxali	नक्सली	नक्सली
nagaada	नगादा	नगाड़ा
nagaadaa	नगादा	नगाड़ा
nagaaraa	नगारा	नगाड़ा
nageene	नागने	नगीने
nagine	नागीन	नगीने
najarandaaj	नजरंंदाज	नजरंदाज
najarandaaz	नज़रंदाज	नजरंदाज
nazarandaaj	नज़रंदाज	नजरंदाज
nazarandaaz	नज़रंदाज	नजरंदाज
nazarandaz	नज़रंंदाज़	नजरंदाज
najraane	नजराने	नजराने
nazraane	नज़राने	नजराने
najariyon	नजारियों	नजरियों
najriyon	नज़िरियों	नजरियों
najron	नजरों	नजरों
najeeb	नजीब	नजीब
najib	नजीब	नजीब
najibabaad	नजीबबाद	नजीबाबाद
najibabad	नजीबबाद	नजीबाबाद
najeem	नजीम	नजीम
najim	नजीम	नजीम
nazeem	नजीम	नजीम
nana	नाना	नना
nanaa	नाना	नना
nna	ननए	नना
nanhe	नन्हें	नन्हें
nanhein	ननहहें	नन्हें
nabj	नब्ज	नब्ज़
nabja	नबजा	नब्ज़
nabz	नब्ज	नब्ज़
namkeen	नमकीन	नमकीन
namkin	नमकीन	नमकीन
narnaari	नररानी	नरनारी
narnari	नरनरी	नरनारी
narbhakshi	नर्भाषकी	नरभक्षी
naram	नरम	नरम
narm	नर्म	नरम
narmi	नर्मी	नरमी
narsanhar	नरसंहर	नरसंहार
narsanharon	नरसाहारों	नरसंहारों
november	न्यूबर	नवंबर
navketan	नवेकतें	नवकेतन
navjaagaran	नवजागरण	नवजागरण
navjagran	नवजगर्गण	नवजागरण
navdha	नवधा	नवधा
navvadhoo	नववादोह	नववधू
navvadhu	नववाधा	नववधू
nava	नवा	नवा
navaa	नवा	नवा
navate	नवाते	नवाते
navanagar	नवानगर	नवानगर
nawanagar	नवानगर	नवानगर
navya	नवया	नव्या
naseem	नसीम	नसीम
nasim	नसीम	नसीम
nights	नाइट्सस	नाइट्रस
nitrous	निट्रोस	नाइट्रस
nineteez	नीनीतेज	नाइनटीज
nineties	निइटेटिस	नाइनटीज
ninties	निइटेस	नाइनटीज
nau	ना	नाऊ
nauu	नौऊ	नाऊ
naakaam	नाकाम	नाकाम
nakam	नकम	नाकाम
naagrik	नागररिक	नागारिक
nagarik	नागरिक	नागारिक
nagrik	नागरिक	नागारिक
nagin	नागीन	नागिन
nadep	नेदेप	नाडेप
nanak	नानक	नानक
nanavati	नानवती	नानावती
napane	नापने	नापने
napne	नापने	नापने
napa	नापा	नापा
naam	नाम	नाम
naamdhari	नामधारी	नामधारी
namdhari	नामधारी	नामधारी
namankano	नमानकों	नामांकनों
namankanon	नमानकों	नामांकनों
namavaliyon	नमावलियों	नामावलियों
naamo	नामो	नामो
namo	नमो	नामो
nayak	नायक	नायक
naraji	नारजी	नाराजी
naraingarh	नररंगढ़	नारायणगढ़
narayangadh	नारायंगढ़	नारायणगढ़
narayangarh	नारायंगढ़	नारायणगढ़
naasar	नासर	नासर
nahargadh	नहरागढ़	नाहरगढ
nahargarh	नहरगगढ़	नाहरगढ
nikalegi	निकलेगी	निकलेगी
nikalogi	निकालोगी	निकलेगी
nikaalani	निकालनी	निकालनी
nikaalni	निकाली	निकालनी
nikalani	निकलनी	निकालनी
nikalni	निकलनी	निकालनी
nicki	निकी	निकी
nicky	निकी	निकी
niki	निकी	निकी
niketan	निकेटन	निकेतन
nikhar	निखर	निखर
nikhari	निखारी	निखरी
nigar	निगर	निगर
nigger	नाइगर	निगर
nichala	निचला	निचला
nichalaa	निचला	निचला
nichla	निचला	निचला
nitiyon	नीतियों	नितियों
nitya	नित्य	नित्या
nityaa	नित्या	नित्या
nidhaan	निधान	निधान
nidhan	निधन	निधान
nipatara	निपटारा	निपटारा
niptaara	निपटारा	निपटारा
niptaaraa	निपटारा	निपटारा
niptara	निपट्रा	निपटारा
niyanta	नियंता	नियंता
niyantaa	नियंता	नियंता
niya	निया	निया
niyaa	निया	निया
nirdeshika	निर्देशिका	निर्देशिका
nirdeshikaa	निर्देशिका	निर्देशिका
nirdhaarit	निर्धारित	निर्धारित
nirdharit	निर्धारित	निर्धारित
nirbaadh	निर्बाध	निर्बाध
nirbadh	निर्बाध	निर्बाध
niveshakartaa	निवेष्करता	निवेशकर्ता
niveshkarta	निवेष्करत	निवेशकर्ता
niveshkartaa	निवेष्करता	निवेशकर्ता
nischal	निस्चल	निश्चल
nishchal	निश्चल	निश्चल
nishnaat	निश्नत	निष्णात
nishpaap	निष्पाप	निष्पाप
nihalaani	निहालनी	निहलानी
nihlaani	निहालनी	निहलानी
nihlani	निहाली	निहलानी
nihaalchand	निहालचंद	निहालचंद
nihalchand	निहालचंद	निहालचंद
neechaaee	नीचाई	नीचाई
nichaai	निचाई	नीचाई
neat	नेत	नीट
neet	नीत	नीट
neetiyon	नीतियों	नीतियों
nitiyon	नीतियों	नीतियों
neelagaay	नीलागय	नीलगाय
nilgai	निगली	नीलगाय
neelaabh	नीलाभ	नीलाभ
nilaabh	निलाभ	नीलाभ
nilabh	निलाभ	नीलाभ
nuskhe	नुस्चे	नुस्खे
noon	नून	नून
nun	नन	नून
noobiyaa	नूबिया	नूबिया
nubiya	नुबिया	नूबिया
nrityashaili	नृत्यशाली	नृत्यशैली
nrutyashaili	नृत्यशाली	नृत्यशैली
nrityon	नृत्यों	नृत्यों
nrutyon	नृत्यों	नृत्यों
neco	नेको	नेको
neko	नेको	नेको
nectar	नेक्टर	नेक्टर
neg	नेग	नेग
nega	नेगा	नेग
networking	नेट्राकिंग	नेटवर्किग
neto	नेटो	नेटो
neta	नेता	नेता
nemo	नेमो	नेमो
nelsan	नेलसन	नेल्सन
nelson	नेल्सन	नेल्सन
nations	नेटिसन	नेशंस
nehara	नेहरा	नेहरा
nehra	नेहरा	नेहरा
naino	नैनो	नैनो
nano	नानो	नैनो
naivedh	नैवेद	नैवेद्य
naivegh	नैवेग	नैवेद्य
nevedya	नेवेद्य	नैवेद्य
nominate	नोमिनेट	नॉमिनेट
naukari	नौकरी	नोकरी
naukri	नौक्री	नोकरी
nokari	नोकरी	नोकरी
nokri	नोकरी	नोकरी
notes	नॉट्स	नोट्स
nora	नोरा	नोरा
nori	नॉरी	नोरी
nauner	नौनर	नौनेर
nauvahan	नौवाहन	नौवहन
naushad	नौशाद	नौशाद
panchaang	पंचांग	पंचांग
panchang	पंचंग	पंचांग
punchang	पंचंग	पंचांग
punjab	पुंजब	पंजाब
punjabiyon	पुंजबियों	पंजाबियों
pantar	पंटर	पंटर
panter	पांटर	पंटर
punter	पंटर	पंटर
pakaayein	पकाएं	पकाएं
pakaayen	पकाएं	पकाएं
pakaen	पकाएं	पकाएं
pakayen	पकाएं	पकाएं
pakaude	पकाड़े	पकौड़े
pakshapat	पक्षापत	पक्षपात
pakshpaat	पक्षपात	पक्षपात
pakshpat	पक्षपत	पक्षपात
pagabadha	पगबड़ा	पगबाधा
pagbadha	पगबगढ़ा	पगबाधा
pagalaa	पगला	पगला
pagla	पगला	पगला
pachaataa	पछाता	पचाता
pachata	पछता	पचाता
patakkar	पटकककर	पटककर
patkathaayein	पटकटाएं	पटकथाएं
patkathaein	पटकटाएं	पटकथाएं
patkathayen	पटकथाएं	पटकथाएं
patki	पटकी	पटकी
pataraani	पतररनी	पटरानी
patrani	पतररणी	पटरानी
patavaari	पतवारी	पटवारी
patwari	पतवारी	पटवारी
pataakshep	पताक्षेप	पटाक्षेप
patachep	पैचेप	पटाक्षेप
patakshep	पतक्षेप	पटाक्षेप
patiya	पटिया	पटिया
patiyaa	पटिया	पटिया
padaraunaa	पदरौना	पडरौना
padrauna	पदरौना	पडरौना
padega	पड़ेगा	पड़ेगा
padegaa	पडेगा	पड़ेगा
padha	पढ़ा	पढ़ा
padhaa	पढ़ा	पढ़ा
padhaataa	पढ़ता	पढ़ाता
padhata	पढ़ता	पढ़ाता
patili	पतीली	पतीली
padamawati	पदमावती	पदमावती
padmavati	पदमावती	पदमावती
padmawati	पदमावती	पदमावती
padadhikari	पदाधिकारी	पदाधिकारी
panapnaa	पनपना	पनपना
panpana	पनपना	पनपना
panaamaa	पनामा	पनामा
panama	पनमा	पनामा
paneer	पानीर	पनीर
pammi	पममी	पम्मी
pammu	पममू	पम्मी
pummi	पममी	पम्मी
pummy	पम्मी	पम्मी
pardesiyon	परदेसियों	परदेसियों
pardesi	परदेसी	परदेसी
parva	परवा	परवा
parvaa	परवा	परवा
parwa	परवा	परवा
parwaa	परवा	परवा
paraadheen	पराधीन	पराधीन
paraadhin	पराधीन	पराधीन
paradheen	पराधीन	पराधीन
paradhin	पराधीन	पराधीन
parikalpit	परीकलिपत	परिकल्पित
parimal	परीमल	परिमल
parishad	परिशाद	परिषद
parishadiy	परिशादीय	परिषदीय
parishadiya	परिशादिय	परिषदीय
parishadon	परिशादों	परिषदों
parikhaen	परीखाएं	परीक्षाएं
parikshaayein	परिक्षाएं	परीक्षाएं
parikshaen	परीक्षाएं	परीक्षाएं
parosane	परोसने	परोसने
parosne	परोसने	परोसने
parda	परदा	पर्दा
pardaa	परदा	पर्दा
purple	पर्पल	पर्पल
palatne	पलतने	पलटने
paltane	पललतेने	पलटने
palaari	पलारी	पलारी
palari	पलरी	पलारी
pale	पाले	पले
palmonari	पलमोनररी	पल्मोनरी
pulmonary	पुलमोनरीय	पल्मोनरी
plus	प्लूस	पल्स
pulse	पुल्स	पल्स
pashtun	पश्तुन	पश्तून
pashtuun	पश्तुओं	पश्तून
pahan	पहन	पहन
pehan	पहन	पहन
pahantaa	पहनता	पहनता
pahnata	पहनता	पहनता
pehnate	पहनते	पहनता
pahanate	पहनते	पहनते
pahante	पहनते	पहनते
pehnate	पहनते	पहनते
pahnaakar	पहनाकार	पहनाकर
pahnakar	पहनकर	पहनाकर
pehnakar	पहनकर	पहनाकर
pahnaati	पहनाती	पहनाती
pahnati	पहनती	पहनाती
pehnati	पहनती	पहनाती
pahani	पहनी	पहनी
pahni	पहनी	पहनी
pehni	पहनी	पहनी
pahno	पहनो	पहनो
pehno	पहनो	पहनो
pahla	पहला	पहला
pahlaa	पहला	पहला
pehla	पहला	पहला
paheliyaan	पहेलियां	पहेलियां
paheliyan	पहेलियां	पहेलियां
paheliyon	पहेलियों	पहेलियों
pide	पीडे	पाइड
pied	पीइड	पाइड
pythagoras	पिथागोगार	पाइथागोरस
pythogaras	पिथोगागार	पाइथागोरस
paakhandi	पाखंडी	पाखंडी
pakhandi	पखंडी	पाखंडी
paathshaalaayein	पाठशालयां	पाठशालाएं
pathshalayein	पथशालयां	पाठशालाएं
pathshalayen	पथशालयां	पाठशालाएं
paathyakram	पाठ्यक्रम	पाठ्यक्रम
pathyakram	पाठ्यक्रम	पाठ्यक्रम
pathykram	पाठ्यक्रम	पाठ्यक्रम
paathyakramon	पाठ्यक्रमों	पाठ्यक्रमों
pathyakramon	पाठ्यक्रमों	पाठ्यक्रमों
pathykramon	पाठ्यक्रमों	पाठ्यक्रमों
population	पूपललियन	पापुलेशन
pailot	पैलोट	पायलट
pilot	पिलोट	पायलट
pailoton	पैलोटों	पायलटों
piloton	पिलोटों	पायलटों
paarampariktaa	पारपपरिकता	पारंपरिकता
paramparikata	परंपरिकता	पारंपरिकता
paramparikta	परंपपरिकता	पारंपरिकता
parnel	परनेल	पार्नेल
parnell	परर्लल	पार्नेल
parleron	पार्लरों	पार्लरों
parloron	परलोरों	पार्लरों
parlouron	परलोरों	पार्लरों
paarshad	पार्शद	पार्षद
parshad	परशाद	पार्षद
paarshadon	पार्दोंं	पार्षदों
parshadon	परशदों	पार्षदों
parshdon	परशदों	पार्षदों
policy	पॉलीसी	पालिसी
pinta	पिंटा	पिंटा
pintaa	पिंटा	पिंटा
piega	पीगा	पिएगा
piyegaa	पीएगा	पिएगा
pic	पीसी	पिक
pick	पीक	पिक
pik	पीक	पिक
piki	पीकी	पिकी
piky	पीकी	पिकी
picture	पिक्टर	पिक्चर
pigmentation	पिगमेंटेशन	पिगमेंटेशन
pigs	पीग्स	पिग्स
pichde	पीछड़े	पिछड़े
pichhade	पछछड़े	पिछड़े
pijja	पीजजा	पिज्जा
pizza	पीज़ाज	पिज्जा
pitaamaha	पीटामा	पितामह
pitamah	पीतामाह	पितामह
pipra	पिप्र	पिपरा
pipraa	पिप्रा	पिपरा
pipli	पीपली	पिपली
pearson	पेरसों	पियरसन
pierson	पीर्सन	पियरसन
peary	पेरी	पियरी
piyari	पियरी	पियरी
pisaai	पिसाई	पिसाई
pisai	पीसाई	पिसाई
pihaani	पिहानी	पिहानी
pihani	पीहानी	पिहानी
pib	पीबी	पीआईबी
pr	प्र	पीआर
pml	पीएलए	पीएमएल
pmo	प्मो	पीएमओ
pmch	पीचची	पीएमसीएच
psv	पीएसी	पीएसवी
peaking	पीकिंग	पीकिंग
picking	पीकिंग	पीकिंग
peetne	पीटने	पीटने
pitne	पीटने	पीटने
pedia	पेड़िया	पीडिया
pidiya	पीड़िया	पीडिया
pidiyaa	पीड़िया	पीडिया
peelepan	पीलेपन	पीलेपन
pilepan	पीलेपन	पीलेपन
pv	पीवी	पीवी
pisa	पीसा	पीसा
putla	पुटला	पुतला
putlaa	पुटला	पुतला
putaliyaan	पुटलियां	पुतलियां
putliyan	पुटलियां	पुतलियां
putaliyon	पुटलियों	पुतलियों
putliyon	पुटलियों	पुतलियों
putali	पुटली	पुतली
putli	पुटी	पुतली
putale	पुटले	पुतले
putle	पुटले	पुतले
putin	पूटिन	पुतिन
putul	पुटुल	पुतुल
punargathan	पुनर्गगठन	पुनर्गठन
puna	पुना	पुना
puraane	पुराने	पुराने
purane	पूराने	पुराने
puru	पुरु	पुरू
purjon	पूर्जों	पुर्जों
purzon	पूर्जों	पुर्जों
pulam	पुलम	पुलम
pushkin	पुष्कीन	पुश्किन
pushkarana	पुष्करण	पुष्करणा
pushkarna	पुष्करण	पुष्करणा
pushkarnaa	पुष्करण	पुष्करणा
pushp	पुष्प	पुष्प
pushpa	पुष्प	पुष्प
pushpa	पुष्प	पुष्पा
pushpaa	पुष्पा	पुष्पा
pushpit	पुष्पित	पुष्पित
pushpon	पुष्पों	पुष्पों
poonjikaran	पूंजीकरण	पूंजीकरण
punjikaran	पुंजीकरण	पूंजीकरण
poojaapaath	पूजापाठ	पूजापाठ
poojapath	पूजापठ	पूजापाठ
pujapath	पुजापठ	पूजापाठ
pooranpur	पूरापुर	पूरनपुर
puranpur	पुरापुर	पूरनपुर
purvaabhaas	पूर्वाभास	पूर्वाभास
purvaabhas	पूर्वाभास	पूर्वाभास
purvabhaas	पूर्वाभास	पूर्वाभास
purvabhas	पूर्वाभास	पूर्वाभास
pendulam	पेंडुलम	पेंडुलम
pendulum	पेंडुलम	पेंडुलम
peg	पेग	पेग
pages	पेज्स	पेजेज
pajej	पजजेज	पेजेज
pace	पेस	पेस
pes	पेस	पेस
pastry	पस््तीय	पेस्ट्री
pangolin	पांगोलीन	पैंगोलिन
pengolin	पेंगोलीन	पैंगोलिन
packard	पककर्ड	पैकर्ड
package	पकेेज	पैकेज
packageon	पकेजों	पैकेजों
packagon	पकागों	पैकेजों
packajon	पकाजों	पैकेजों
paim	पैम	पैम
pam	पा	पैम
paratrooper	परततरपर	पैराट्रूपर
peratrupers	पर्टर्रर्स	पैराट्रूपर
paranormal	पररणोनल	पैरानॉर्मल
peranormal	परररानोल	पैरानॉर्मल
paraffin	परफफीन	पैराफिन
parafin	परफीीन	पैराफिन
perafin	परफीन	पैराफिन
parabola	परबबला	पैराबोला
perabola	परबोला	पैराबोला
polimer	पॉलियर	पॉलिमर
polymer	पॉलियर	पॉलिमर
polishing	पोलिशिंग	पॉलिशिंग
pokar	पोकर	पोकर
poker	पोकर	पोकर
polish	पोलिश	पोलिश
poshit	पोषित	पोषित
posta	पोस्ट	पोस्ता
pau	पौ	पौ
pyade	प्यादे	प्यादे
prakriya	प्रक्रिया	प्रक्रिया
prakshepak	प्रक्षेपक	प्रक्षेपक
pratigya	प्रतिग्ञा	प्रतिज्ञा
prtigyaa	प्रतिग्या	प्रतिज्ञा
pratibhutiyan	प्रतिभूतियां	प्रतिभूतियां
pratiyon	प्रतियों	प्रतियों
prativaad	प्रतिवाद	प्रतिवाद
prativad	प्रतिवाद	प्रतिवाद
prativadi	प्रतिवादी	प्रतिवादी
pratishat	प्रतिष्ट	प्रतिशत
praneet	प्रणीत	प्रनीत
pranit	प्रणीत	प्रनीत
prapaat	प्रपात	प्रपात
prapat	प्रपत	प्रपात
prapaaton	प्रपततों	प्रपातों
prapaton	प्रपत्तों	प्रपातों
prabodhini	प्रबोधीनी	प्रबोधिनी
prayaasrat	प्रयास्त	प्रयासरत
prayasarat	प्रयसररत	प्रयासरत
pradarshan	प्रदर्शन	प्रर्दशन
prardashan	प्रदर्शन	प्रर्दशन
pravati	प्रवती	प्रवत्ति
pravatti	प्रवत्ती	प्रवत्ति
prashaasanik	प्रशासनिक	प्रशासनिक
prashasanik	प्रशासनिक	प्रशासनिक
prashasnik	प्रशासनिक	प्रशासनिक
prashaasanon	प्रशासनों	प्रशासनों
prashansanon	प्रशंसनों	प्रशासनों
prashasanon	प्रशासनों	प्रशासनों
prashikshu	प्रशिक्षु	प्रशिक्षु
prastaavon	प्रस्तवाों	प्रस्तावों
prastavon	प्रस्तवों	प्रस्तावों
prahlaad	प्रहालाद	प्रहलाद
prahlad	प्रहालद	प्रहलाद
prahasan	प्रहससन	प्रहसन
prahsan	प्रासहन	प्रहसन
prahaarak	प्रहारक	प्रहारक
praharak	प्राराक	प्रहारक
prahad	प्रहाद	प्रह्लाद
prahlad	प्रहालद	प्रह्लाद
privacy	प्रिवेसी	प्राइवेसी
praakkathan	प्रकक्थन	प्राक्कथन
prakkathan	प्रकक्थन	प्राक्कथन
praan	प्राण	प्राण
pran	प्रान	प्राण
pranon	प्रणों	प्राणों
prathamik	प्रामामिक	प्राथमिक
prathmik	प्रामथिक	प्राथमिक
praathmikata	प्रामतिकता	प्राथमिकता
prathmikta	प्राम्थिकता	प्राथमिकता
prathmiki	प्रथमिकी	प्राथमिकी
pradhyapakon	प्रधायापकों	प्राध्यापकों
prapt	प्रपत्त	प्राप्त
prapta	प्रपत्ता	प्राप्त
prapti	प्रपती	प्राप्ती
praroop	प्रपूप	प्रारूप
prarup	प्रपूप	प्रारूप
priyamani	प्रियमणी	प्रियामणि
proof	प्रूफ	प्रूफ
pruf	प्रूफ	प्रूफ
prekshakon	प्रेक्षकों	प्रेक्षकों
prem	प्रेम	प्रेम
premlata	प्रेमलता	प्रेमलता
prema	प्रेमा	प्रेमा
premi	प्रेमी	प्रेमी
profit	प्रोफिट	प्रॉफिट
processing	प्रोसेजिंग	प्रॉसेसिंग
programers	प्रोग्रामर्स	प्रोग्रामर्स
programmers	प्रोग्राम्जर्स	प्रोग्रामर्स
programs	प्रोग्रास	प्रोग्रामर्स
proto	प्रोटो	प्रोटो
propellant	प्रॉफलेंट	प्रोपेलेंट
propellent	प्रॉफलेटल्ट	प्रोपेलेंट
praudh	प्रौढ़	प्रौढ
proud	प्रौड	प्रौढ
plan	प्लान	प्लेन
plane	प्लाने	प्लेन
fund	फंड	फंड
funda	फंडा	फंडा
funding	फंडिंग	फंडिंग
fandon	फैंडों	फंदों
fagua	फगगू	फगुआ
fatane	फटने	फटने
phatane	फटने	फटने
phatne	फटने	फटने
fadfadata	फफड़दाता	फड़फड़ाता
phadphadata	फफ़दड़ता	फड़फड़ाता
fatehgadh	फतेहगगढ़	फतेहगढ़
fatehgarh	फतेहगढ़	फतेहगढ़
fabti	फबती	फब्ती
phabti	फबती	फब्ती
farse	फर्से	फरसे
pharase	फरासे	फरसे
pharse	फर्से	फरसे
farheen	फरहीन	फरहीन
farhin	फरहीं	फरहीन
farth	फर्थ	फर्थ
ferth	फर्थ	फर्थ
pharth	फर्थ	फर्थ
farmion	फर्मियन	फर्मिऑन
fermion	फर्मिन	फर्मिऑन
firmian	फर्मियन	फर्मिऑन
farookhabad	फरुखाबाद	फर्रुखाबाद
farrukhabad	फररखबाबाद	फर्रुखाबाद
farukhabad	फरुखाबाद	फर्रुखाबाद
farookhnagar	फरुखनागर	फर्रूखनगर
farrukhnagar	फररखनगर	फर्रूखनगर
farukhnagar	फरुखनगर	फर्रूखनगर
falata	फलता	फलता
falta	फलता	फलता
phalata	फलता	फलता
falne	फलने	फलने
phalne	फलने	फलने
falitarth	फलीत्राथ	फलितार्थ
phalitartha	फलित्राथ	फलितार्थ
falibhoot	फलीभूत	फलीभूत
falibhut	फलीभूत	फलीभूत
phalibhoot	फलीभूत	फलीभूत
favvara	फववारा	फव्वारा
fawaara	फवाारा	फव्वारा
favvare	फववेरे	फव्वारे
fawaare	फवायरे	फव्वारे
favvaron	फववारों	फव्वारों
fawaaron	फवायरों	फव्वारों
faisala	फैसला	फ़ैसला
faisla	फैसला	फ़ैसला
follow	फोल	फ़ॉलो
faansi	फांसी	फांसी
fansi	फैंसी	फांसी
fatama	फटमा	फातमा
fatma	फटममा	फातमा
faaf	फाफ	फाफ
phaaph	फाफ	फाफ
farsi	फरसी	फारसी
forcee	फॉर्सी	फारसी
farm	फर्म	फार्म
form	फॉर्म	फार्म
farmic	फरम्किक	फार्मिक
formic	फॉर्मिक	फार्मिक
formulae	फॉर्मोलाई	फार्मूले
formule	फॉर्मूल	फार्मूले
formuley	फॉर्मलली	फार्मूले
pharmacy	फरम्मी	फार्मेसी
pharma	फरमा	फार्मों
pharmon	फरमों	फार्मों
farms	फर्म्स	फार्म्स
finger	फिंगर	फिंगर
fikra	फिक्रा	फिक्र
physician	फिसिसियन	फिजिशियन
firti	फर्ती	फिरती
fisla	फिसला	फिसला
fislaa	फिसला	फिसला
feeder	फीदर	फीडर
fulaaye	फुलाए	फुलाए
fulae	फूलाई	फुलाए
fulay	फूलय	फुलाए
furti	फूर्ती	फूर्ति
phurti	फूर्ती	फूर्ति
fus	फस	फूस
phoos	फूस	फूस
phus	फुस	फूस
feka	फेका	फेका
fefada	फफेदा	फेफड़ा
fefda	फफेदा	फेफड़ा
facial	फैसिल	फेशियल
fact	फैक्ट	फैक्ट
federal	फेडरल	फैडरल
failkar	फैलकर	फैलकर
failaaiye	फैलाई	फैलाइए
failaea	फैलाई	फैलाइए
failaiya	फैलाया	फैलाइए
failaiye	फैलाए	फैलाइए
failegi	फैलेगी	फैलेगी
font	फॉन्ट	फॉन्ट
fogat	फोगत	फोगाट
phogat	फोगत	फोगाट
fod	फोड	फोड़
phod	फोड	फोड़
foda	फोड़ा	फोड़ा
fodaa	फोड़ा	फोड़ा
phoda	फोड़ा	फोड़ा
fode	फोड़े	फोड़े
phode	फोड़े	फोड़े
fodo	फोडो	फोड़ों
fodon	फोड़ों	फोड़ों
phodo	फोडो	फोड़ों
fortis	फॉर्टिस	फोर्टिस
fusion	फससन	फ्यूजन
fuji	फूजी	फ्यूजी
fyuji	फ्यूजी	फ्यूजी
francisca	फ्रेंसिसिक	फ्रांसिस्का
franciska	फ्रेंसिक्स	फ्रांसिस्का
fransiska	फ्रेंसिका	फ्रांसिस्का
francisco	फ्रेंसिक्सो	फ्रांसिस्को
francisko	फ्रेंसिक्को	फ्रांसिस्को
fransisko	फ्रेंसिकों	फ्रांसिस्को
fringe	फ्राइंग	फ्रिंज
friendship	फ्रेंडिशपी	फ्रेंडशिप
frost	फ्रोस्ट	फ्रॉस्ट
flin	फ्लीन	फ्लिन
flynn	फ्लीनन	फ्लिन
flesh	फ्लेश	फ्लेश
bang	बंग	बंग
bung	बंग	बंग
bangbandhu	बंंबंगुढ़	बंगबंधु
bangbhang	बंगगंग	बंगभंग
bangash	बंगाश	बंगश
bangsh	बंगगश	बंगश
bantane	बंटाने	बंटने
bantne	बानते	बंटने
bandhati	बंधती	बंधती
bandhti	बंधती	बंधती
bandhan	बांधन	बंधान
bandhuon	बंधुओं	बंधुओं
bamba	बांबा	बंबा
mumba	मुंबा	बंबा
bakaayon	बकायों	बकायों
bakayon	बकायों	बकायों
bakaul	बकाल	बकौल
bakoul	बाकूल	बकौल
baksa	बकसा	बक्सा
baksi	बकसी	बक्सी
bakse	बकसे	बक्से
bakhshane	बख्शने	बख्शने
bakhshne	बख्शने	बख्शने
bagad	बागड़	बगड़
bagd	बागड़	बगड़
bageechi	बगीची	बगीची
bagichi	बगीची	बगीची
bachat	बचात	बचत
bachati	बचती	बचती
bachti	बचती	बचती
bajana	बजना	बजना
bajrangi	बजरंगी	बजरंगी
bajaj	बजजज	बजाज
batalvi	बतलवी	बटालवी
badhachadhakar	बढ़चाचार	बढ़ाचढ़ाकर
badata	बड़ता	बढ़ाता
badhaataa	बढ़ता	बढ़ाता
badhata	बढ़ता	बढ़ाता
badhaati	बढ़ती	बढ़ाती
badhati	बढ़ती	बढ़ाती
badhayi	बढ़ाई	बढ़ायी
badhav	बाधव	बढ़ाव
badhotari	बाधोतरी	बढ़ोतरी
badhotri	बाधोत्री	बढ़ोतरी
batlaae	बतलाए	बतलाए
batlaaye	बतलाए	बतलाए
batlae	बतलाई	बतलाए
batlaye	बतलाए	बतलाए
batlaakar	बटलाकार	बतलाकर
batlakar	बटलाकर	बतलाकर
badlapur	बदलापुर	बदलापुर
badali	बदली	बदली
badli	बदली	बदली
badam	बदम	बदाम
banva	बनवा	बनवा
banvaa	बनवा	बनवा
banaam	बनाम	बनाम
banam	बनाम	बनाम
bnaam	बनाम	बनाम
baniya	बनिया	बनिया
banu	बानु	बनू
barpaayaa	बर्पाया	बरपाया
barpaya	बर्पया	बरपाया
barsa	बरससा	बरसा
barsaata	बरसाता	बरसाता
barsaataa	बरसाता	बरसाता
barsata	बरससता	बरसाता
barhad	बरहद	बरहद
baraat	बरात	बरात
barat	बरत	बरात
braat	ब्रात	बरात
baraamad	बरमाद	बरामद
baramad	बरमाद	बरामद
bramad	ब्रामड	बरामद
baramade	बरमादे	बरामदे
baramde	बरमदे	बरामदे
bare	बारे	बरे
birth	बीर्थ	बर्थ
baljeet	बलजीत	बलजीत
baljit	बालजीत	बलजीत
ballabh	बल्लाभ	बल्लभ
balla	बल्ला	बल्ला
balli	बल्ली	बल्ली
basava	बसवा	बसावा
bastiyon	बस्तियों	बस्तियों
bahroopiya	बहरूपिय	बहरूपिया
bahrupiya	बहरुपिय	बहरूपिया
bahamaas	बहमास	बहामास
bahamas	बहमास	बहामास
bahaav	बहाव	बहाव
bahav	बहव	बहाव
bhav	भाव	बहाव
bahavalpur	बहवलपुर	बहावलपुर
bahawalpur	बहवललपुर	बहावलपुर
bahuchara	बहुचारा	बहुचरा
banthia	बांठिया	बांठिया
banthiya	बांठीय	बांठिया
bandhate	बंधते	बांधते
bandhte	बंधते	बांधते
banbi	बांबी	बांबी
bombi	बोंबी	बांबी
bounceron	बाउंसरों	बाउंसरों
bowling	बॉलिंग	बाउलिंग
baku	बाकू	बाकू
bakuu	बकुऊ	बाकू
baag	बाग	बाग
bag	बाग	बाग
bagh	बाघ	बाग
bagabani	बगबानी	बागबानी
bagbani	बागबनी	बागबानी
bagali	बगली	बागली
bagli	बगली	बागली
baagiyon	बागियों	बागियों
bagiyon	बगीयों	बागियों
baago	बागो	बागो
bago	बागो	बागो
baji	बाजी	बाज़ी
bazi	बाजी	बाज़ी
bajaru	बजारू	बाजारू
bazaru	बजरू	बाजारू
bajuon	बाजूओं	बाजुओं
badh	बाध	बाध
badha	बढ़ा	बाधा
baadhaaon	बाधाओं	बाधाओं
baadhaon	बाधाओं	बाधाओं
badhaaon	बढ़ाओं	बाधाओं
badhaon	बढ़ाओं	बाधाओं
baadhit	बाधित	बाधित
badhit	बाधित	बाधित
baani	बानी	बानी
bani	बनी	बानी
baapa	बापा	बापा
baapaa	बापा	बापा
bapa	बापा	बापा
bapaa	बपा	बापा
baabat	बाबत	बाबत
babat	बबत	बाबत
babt	बबत	बाबत
bayern	बैयरन	बायर्न
byrun	बार्न	बायर्न
barah	बारहह	बारह
baarahamaasee	बारहमहसी	बारहमासी
barahamasi	बरहमासी	बारहमासी
barahmasi	बरहमसाही	बारहमासी
barahsinga	बररहसिंह	बारहसिंगा
barasingha	बरसींघा	बारहसिंगा
bala	बला	बाला
baalti	बालती	बाल्टी
balti	बालती	बाल्टी
balty	बाल्टी	बाल्टी
baldvin	बाल्वीन	बाल्डविन
baldwin	बाल्वीं	बाल्डविन
bavaji	बावजी	बावजी
bavji	बावजी	बावजी
baawaraa	बावरा	बावरा
bavra	बावरा	बावरा
bawara	बावरा	बावरा
baahulya	बाहुल्य	बाहुल्य
bahuly	बहुल्य	बाहुल्य
bahulya	बहुल्य	बाहुल्य
box	बॉक्स	बाॅक्स
bikherati	बिखरेती	बिखेरती
bikherti	बिखरती	बिखेरती
biggest	बागग्सेट	बिगेस्ट
bichhua	बिछुआ	बिछुआ
bichhuaa	बिछुआ	बिछुआ
biji	बीजी	बिजी
busy	बस्सी	बिजी
buzy	बुज्य	बिजी
bipin	बीपीन	बिपिन
bilae	बिलाई	बिलाई
bilai	बिलाई	बिलाई
billa	बिल्ला	बिल्ला
billaa	बिल्ला	बिल्ला
bilhaur	बिलहहौर	बिल्हौर
bisva	बिस्वा	बिस्वा
biswa	बिस्वा	बिस्वा
bag	बाग	बीएजी
bikaner	बिकनेर	बीकानेर
bikaneri	बिकनेरी	बीकानेरी
bk	बीके	बीके
beejak	बीजक	बीजक
bijak	बीजक	बीजक
beef	बीफ	बीफ
beem	बीम	बीम
bim	बीम	बीम
beemon	बीमों	बीमों
bimon	बीमों	बीमों
beerganj	बीरंगज	बीरगंज
birganj	बीर्गज	बीरगंज
beesavaan	बीसवान	बीसवां
bisavan	बीसवान	बीसवां
bisawan	बीसवान	बीसवां
beast	बेस्ट	बीस्ट
budvig	बुद्विग	बुडविग
budwig	बुद्विग	बुडविग
bull	बुल	बुल
bulaao	बुलाओ	बुलाओ
bulao	बुलाओ	बुलाओ
bule	बुले	बुले
bulletin	बललेटिं	बुलेटिन
brijesh	ब्रेजेश	बृजेश
benvar	बेनवार	बेंवर
benwar	बेनवार	बेंवर
beaulad	बेलाद	बेऔलाद
bekaaboo	बेकाबू	बेकाबू
bekabu	बेकबू	बेकाबू
bechakar	बेचकर	बेचकर
bechkar	बेचकर	बेचकर
bechate	बेचते	बेचते
bechte	बेचते	बेचते
bediyan	बेडियां	बेड़ियां
bethanal	बेथनाल	बेथनल
bethnal	बेथनल	बेथनल
benis	बेनिस	बेनिस
belacha	बेलाचा	बेलचा
belcha	बेल्चा	बेलचा
belinda	बिलंदा	बेलिंडा
bevkufana	बेवकूफना	बेवकूफाना
bewakoofaanaa	बेवकोफना	बेवकूफाना
bewkufana	बेवुकफाना	बेवकूफाना
besahaaraa	बेशाहारा	बेसहारा
besahara	बेसहारा	बेसहारा
basin	बसीन	बेसिन
besin	बेसन	बेसिन
basil	बसील	बेसिल
besil	बेसिल	बेसिल
bandage	बंडागे	बैंडेज
bandej	बांजेे	बैंडेज
baithantey	बैठतेे	बैठते
baithate	बैठते	बैठते
baitool	बैटू	बैतूल
baitul	बैटुल	बैतूल
betul	बेटूल	बैतूल
baini	बैनी	बैनी
beni	बेनी	बैनी
bairakpur	बैरकपुर	बैरकपुर
barrackpore	बरर्पकेर	बैरकपुर
baila	बैला	बैला
bella	बेला	बैला
ballistic	बल्लिस्टिक	बैलिस्टिक
bells	बेल्स	बैल्स
bostan	बोस्टन	बॉस्टन
bosten	बॉस्टन	बॉस्टन
boston	बोस्टों	बॉस्टन
bokaro	बोकरो	बोकारो
bodara	बोड़रा	बोदरा
bodra	बोद्रा	बोदरा
bodraa	बोदरा	बोदरा
bona	बोना	बोना
borkar	बोर्कर	बोरकर
borivali	बोरिवाली	बोरीवली
boriwali	बोरिवाली	बोरीवली
born	बॉर्न	बोर्न
bolane	बोलने	बोलने
boliae	बोलिया	बोलिए
boliy	बोली	बोलिए
boliye	बोलीय	बोलिए
bosaan	बोसान	बोसान
bosan	बोसन	बोसान
bauni	बौनी	बौनी
bouni	बौनी	बौनी
byaawa	ब्यावा	ब्यावर
byavar	ब्यावर	ब्यावर
brajesh	ब्रेजेश	ब्रजेश
brijesh	ब्रेजेश	ब्रजेश
brahmalin	ब्रह्मालीन	ब्रह्मलीन
brahmleen	ब्रह्मलीन	ब्रह्मलीन
brahmlin	ब्रह्मिन	ब्रह्मलीन
bravo	ब्रावो	ब्रावो
brigatn	ब्रागटन	ब्रिगटन
brighton	ब्रिटों	ब्रिगटन
brigton	ब्रिट्गों	ब्रिगटन
brigadier	ब्रिगाड़र	ब्रिगेडियर
britain	ब्रिटें	ब्रिटेन
breed	ब्रीड	ब्रीद
brock	ब्रॉक	ब्रोक
brok	ब्रोक	ब्रोक
broke	ब्रोक	ब्रोक
brocken	ब्रोकेन	ब्रोकन
broken	ब्रोकेन	ब्रोकन
blosam	ब्लोसम	ब्लॉसम
blossom	ब्लोसम	ब्लॉसम
bhagaane	भगाने	भगाने
bhagane	भगाने	भगाने
bhadakaaya	भड़काया	भड़काया
bhadakaya	भड़काया	भड़काया
bhadkaayaa	भड़काया	भड़काया
bhadkaya	भड़काया	भड़काया
bharakaaya	भड़काया	भड़काया
bharakaya	भरकाया	भड़काया
bhabhoot	भभूत	भभूत
bhabhut	भभूत	भभूत
bhay	भाय	भय
bhaya	भया	भय
bhayo	भायो	भयो
bharatanatyam	भारतात्मय	भरतनाट्यम्
bharatnatyam	भारतन्यतम	भरतनाट्यम्
bhartnatyam	भार्तन्यतम	भरतनाट्यम्
bharate	भरतते	भरते
bharte	भर्ते	भरते
bharani	भरणी	भरनी
bharni	भरणी	भरनी
bharane	भराने	भरने
bharne	भरने	भरने
bhara	भरा	भरा
bhavishya	भविष्या	भविष्य
bhaate	भाते	भाते
bhate	भटते	भाते
bhanu	भानु	भानू
bhabar	भाबर	भाबर
bhareeye	भारीय	भारीय
bhariy	भारीय	भारीय
bhavanaon	भवानाओं	भावनाओं
bhavnaon	भवनाओं	भावनाओं
bhaskar	भासकर	भास्कर
bheed	भीड़	भीड़
bheera	भीरा	भीरा
bhira	भीरा	भीरा
bheesham	भीषम	भीष्म
bhisham	भिष्म	भीष्म
bhishm	भिष्म	भीष्म
bhugat	भुगत	भुगत
bhugata	भुगता	भुगता
bhugta	भुग्त	भुगता
bhutto	भुट्टो	भुट्टो
bhumi	भूमी	भुमि
bhurbhura	भूरभूरा	भुरभुरा
bhookh	भूख	भूख
bhukh	भूख	भूख
bhookhi	भूखी	भूखी
bhukhi	भूखी	भूखी
bhoogol	भूगोल	भूगोल
bhugol	भुगोल	भूगोल
bhootal	भूटल	भूतल
bhutal	भूटल	भूतल
bhoopsingh	भूपिंह	भूपसिंह
bhupsingh	भुपिंह	भूपसिंह
bhumi	भूमी	भूमी
bhumika	भूमिका	भूमी
bhulata	भुलता	भूलता
bhulataa	भुलता	भूलता
bhulta	भुलता	भूलता
bhula	भुला	भूला
bhulaa	भुला	भूला
bhooli	भूली	भूली
bhuli	भूली	भूली
bhulo	भूलो	भूलो
bhulon	भूलों	भूलों
bhusi	भूसी	भूसी
bhooswaami	भूस्वामी	भूस्वामी
bhusvami	भुस्वमी	भूस्वामी
bhuswami	भुस्वामी	भूस्वामी
bhengapan	भेंगापन	भेंगापन
bhairavnath	भैरानवाथ	भैरवनाथ
bhairo	भैरो	भैरो
bhogatey	भोगते	भोगते
bhogte	भोगते	भोगते
bhola	भोला	भोला
bholi	भोली	भोली
bholu	भोलू	भोलू
bhaunho	भौनोह	भौंहों
bhaunhon	भौनों	भौंहों
bhoonhon	भूनों	भौंहों
bhraant	भ्रांत	भ्रांत
bhrant	भ्रांत	भ्रांत
brant	ब्रांट	भ्रांत
bhraanti	भ्रांति	भ्रांति
bhranti	भ्रांति	भ्रांति
branti	ब्रांती	भ्रांति
bhraantiyan	भ्रांतियां	भ्रांतियां
bhrantiyan	भ्रांतियां	भ्रांतियां
bhraantiyon	भ्रांतियों	भ्रांतियों
bhrantiyon	भ्रांतियों	भ्रांतियों
mangesh	मंगेश	मंगेश
manch	मंच	मंच
manchit	मानचित	मंचित
mancheeye	मनचीय	मंचीय
manchiy	माचीय	मंचीय
manchiya	माचिया	मंचीय
manchon	मांचों	मंचों
manjil	मंजील	मंजिल
manzil	मंजील	मंजिल
manjila	मंजीला	मंजिला
manzila	मंजीला	मंजिला
manjilein	मंजललें	मंजिलें
manjilen	मंजीलें	मंजिलें
manzilein	मंजिलें	मंजिलें
manto	मंटो	मंटो
mantriyon	मंत्रियों	मंत्रियों
makrani	मकरानी	मकरानी
maksad	मकसाद	मक्सद
makhdumpur	मकदमुपुर	मखदुमपुर
machaaye	मचाए	मचाए
machae	मचाए	मचाए
machaye	मचाए	मचाए
machaanon	मशानों	मचानों
machanno	मचननों	मचानों
machano	मचनों	मचानों
machanon	मचानों	मचानों
madaura	मादौरा	मढ़ौरा
madhuara	मधुरा	मढ़ौरा
madhura	मधुरा	मढ़ौरा
manipal	मानपाल	मणिपाल
matpatron	मतपत्रों	मतपत्रों
matthe	मत्थे	मत्थे
matsyavatar	मात्यस्यतार	मत्स्यावतार
matsyavtar	मात्यस्यत्र	मत्स्यावतार
masyendranath	मसस्नेद्राथ	मत्स्येंद्रनाथ
matsyendranath	मात्संद्रंधन	मत्स्येंद्रनाथ
madhupur	मधुपुर	मधुपुर
manmarji	मनमरजजी	मनमर्जी
manae	मनाए	मनाए
manaye	मनाए	मनाए
mnaey	मनाए	मनाए
mam	मम	मम
mum	मूम	मम
maryokar	मार्योकर	मयोर्का
mayorka	मायोका	मयोर्का
mayorkaa	मायोका	मयोर्का
mardaani	मरदानी	मरदानी
mardani	मरदानी	मरदानी
marmar	मरमार	मरमर
murmur	मुरूर	मरमर
maratha	मररथा	मराठा
marathi	मररथी	मराठी
marji	मर्जी	मर्जी
mardanagi	मरदागी	मर्दानगी
mardangi	मरदगगी	मर्दानगी
mardo	मर्डो	मर्दों
mardon	मर्दों	मर्दों
maryaadaa	मरराया	मर्यादा
maryada	मरर्या	मर्यादा
maryaadaaon	मर्यादाओं	मर्यादाओं
maryadaon	मरर्याओं	मर्यादाओं
malaga	मलागा	मलागा
malaar	मलार	मलार
malar	मलार	मलार
mashrak	मशर्क	मशरक
masaaledaar	मसालेदार	मसालेदार
masaledaar	मसलेदार	मसालेदार
masaledar	मसलेदार	मसालेदार
masoor	मसूर	मसूर
masur	मसूर	मसूर
masse	मससे	मस्से
mahakane	महकाने	महकने
mahakne	महकाने	महकने
mahkane	महकाने	महकने
mehkane	महकाने	महकने
mahalon	महालों	महलों
mahlon	महलों	महलों
mahagranth	महाग्रथ	महाग्रंथ
mhagranth	महगग्रथ	महाग्रंथ
mahajan	महजन	महाजन
mhajan	महजन	महाजन
mahathir	महातिर	महाथिर
mhathir	महातिर	महाथिर
mahanatam	महानतम	महानतम
mahantam	महंतम	महानतम
mhantam	महंतम	महानतम
mahanideshak	महानिशेदक	महानिदेशक
mahanirdeshak	महानिरेद्षक	महानिदेशक
mhanideshak	महानिदेशक	महानिदेशक
mahapauron	महापुरों	महापौरों
mhapauron	महापुरों	महापौरों
mahapran	महाप्रण	महाप्राण
mhapran	महप्रण	महाप्राण
mahamantr	महामंत्र	महामंत्र
mahamantra	महामंत्र	महामंत्र
mhamantra	महमांत्र	महामंत्र
maharaja	महाराज	महाराजा
mahavigyan	महाविज्ञान	महाविज्ञान
mhavidyan	महाविद्यान	महाविज्ञान
mahavidya	महाविद्या	महाविद्या
mhavidya	महाविद्य	महाविद्या
mahavishnu	महाविष्णु	महाविष्णु
mahasingh	महासिंह	महासिंह
mahasinh	महासिहं	महासिंह
mahipal	महिपल	महिपाल
mahin	महीं	महीन
mahinon	महिनों	महीनों
maang	मांग	मांग
mang	मंग	मांग
mangani	मंगनी	मांगनी
mangni	मंगनी	मांगनी
maanga	मांगा	मांगा
manga	मंगा	मांगा
maangi	मांगी	मांगी
mangi	मंगी	मांगी
maange	मांगे	मांगे
mange	मंजे	मांगे
mango	मंगो	मांगो
maori	मारी	माओरी
maajin	माजीन	माजिन
majin	माजीन	माजिन
mathe	मथे	माथे
mathey	मैथे	माथे
maap	माप	माप
map	मैप	माप
mop	मोप	माप
mamooli	माूली	मामूली
mamuli	मामुली	मामूली
mame	मेम	मामे
maarvaad	मारवाद	मारवाड़
marvad	मरवाद	मारवाड़
marwar	मरवार	मारवाड़
maariya	मारिया	मारिया
mariya	मरिया	मारिया
maariyo	मारियो	मारियो
mario	मरियो	मारियो
mariyo	मरियो	मारियो
martha	मर्था	मार्था
maalish	मालिश	मालिश
malish	मालिश	मालिश
mave	मावे	मावे
mavey	मेवे	मावे
maas	मास	मास
mas	मस	मास
mass	मसस	मास
maason	मासों	मासों
mason	मसों	मासों
mitaao	मिटाओ	मिटाओ
mitao	मिटाओ	मिटाओ
mithaai	मिठाई	मिठाई
mithai	मिथाई	मिठाई
media	मेडिया	मिडिया
mithila	मिथिला	मिथिला
mithilanchal	मिथललंल	मिथिलांचल
mithya	मिथ्या	मिथ्या
mimicry	मिमिक्रीी	मिमिक्री
milkiyat	मिलकियत	मिल्कियत
misha	मिशा	मिशा
mungeri	मुंगरी	मुंगेरी
mundva	मुंडवा	मुंडवा
mundwa	मुंडवा	मुंडवा
munshiganj	मुशंगिंज	मुंशीगंज
mukarte	मुकर्ते	मुकरते
mukartey	मुकर्ते	मुकरते
mukhopadhyaya	मुख्योपाधय	मुखोपाध्याय
mukhyopadhyaay	मुख्योपाध्याय	मुखोपाध्याय
mukhyamantri	मुख्यमंत्री	मुख्यमंत्री
munaf	मूनफ	मुनाफ
munafa	मुनफा	मुनाफा
munnu	मुनूनू	मुन्नू
mufalisi	मुफलिसी	मुफलिसी
muflisi	मूल्सी	मुफलिसी
mubarakpur	मुकारपुकर	मुबारकपुर
mubarkpur	मुकरबपुर	मुबारकपुर
murjha	मुर्झा	मुर्झा
multae	मुलतता	मुल्ताई
multai	मूलताई	मुल्ताई
mushahid	मुशाहिद	मुशाहिद
muhavare	मुहावेे	मुहावरे
muhavre	मुहावेे	मुहावरे
mooth	मूथ	मूठ
muth	मूथ	मूठ
mood	मूद	मूड
mud	मुद	मूड
moodi	मूदी	मूडी
moody	मूदी	मूडी
mool	मूल	मूल
mul	मूल	मूल
moolchand	मूचलंद	मूलचंद
mulchand	मूलचंद	मूलचंद
moolar	मूलर	मूलर
mular	मुलर	मूलर
muller	मूलर	मूलर
moolon	मूलों	मूलों
mulon	मूलों	मूलों
maxico	मैक्सिको	मेक्सिको
mexico	मेक्सिको	मेक्सिको
mega	मेगा	मेगा
megapixal	मेगीपासिकल	मेगापिक्सल
megapixel	मेगीपासिस	मेगापिक्सल
mejbaan	मजबान	मेजबान
mejban	मजबान	मेजबान
mezbaan	मेबान	मेजबान
mejabani	मजबानी	मेजबानी
mejbaani	मेजबानी	मेजबानी
mejbani	मेजबनी	मेजबानी
mezabani	मेजाबनी	मेजबानी
mejbaan	मजबान	मेज़बान
mejban	मजबान	मेज़बान
mezbaan	मेबान	मेज़बान
mejbaani	मेजबानी	मेज़बानी
mejbani	मेजबनी	मेज़बानी
mezbaani	मेजबानी	मेज़बानी
mate	माटे	मेट
met	मेट	मेट
mates	मैट्स	मेट्स
medical	मेडिकल	मेडीकल
methanol	मेथनल	मेथेनॉल
menu	मेनू	मेनू
mem	मेम	मेम
melaghaat	मेलगाघट	मेलघाट
melghat	मेघलात	मेलघाट
melaanin	मेलानीन	मेलानिन
melanin	मेलनीन	मेलानिन
melaani	मेलानी	मेलानी
melani	मेलनी	मेलानी
maheman	महमें	मेहमान
mehamaan	मेहमान	मेहमान
mehaman	मेहमन	मेहमान
mehmaan	मेमान	मेहमान
mehman	मेहमन	मेहमान
meharaam	मेहरम	मेहराम
mehram	मेहरम	मेहराम
macbook	मकबूक	मैकबुक
matix	मैटिक्स	मैट्रिक्स
matrix	माट्रिक्स	मैट्रिक्स
mad	माद	मैड
made	मेड	मैड
maid	मैद	मैड
maddy	मद्दी	मैडी
maidi	मैदी	मैडी
main	मैन	मैन
man	मन	मैन
men	मेन	मैन
mainan	मैनन	मैनन
menon	मेनों	मैनन
manner	मननर	मैनर
maina	मैना	मैना
maine	मैने	मैने
marrej	मररेज	मैरेज
marriage	मररिइज	मैरेज
merraige	मररेज	मैरेज
maisachusets	मैसासेशम्सस	मैसाचुसेट्स
massachusetts	मससस्चेत्सस	मैसाचुसेट्स
maisor	मैसोर	मैसोर
maisore	मैसोरे	मैसोर
mysore	माइसर	मैसोर
mod	मोड	मॉड
mode	मोडे	मॉड
modern	मॉडरन	मॉडर्न
module	मोडलल	मॉड्यूल
modules	मोडल्स	मॉड्यूल्स
modyuls	मोडियल्स	मॉड्यूल्स
mauritious	मॉरियूजस	मॉरिशस
mauritius	मॉरिटियूस	मॉरिशस
mogali	मोगली	मोगली
mowgli	मोगली	मोगली
motive	मोटीव	मोटिव
mol	मोल	मोल
mold	मोल्ड	मोल्ड
moshe	मोशे	मोशे
mosad	मोसाद	मोसाद
mohana	मोहना	मोहाना
mohani	मोहनी	मोहानी
mohini	मोहिनी	मोहिनी
mohim	मोहिम	मोहिम
maukon	मौकों	मौकों
mauma	मौमा	मौमा
maurya	मौर्य	मौर्या
morya	मोर्य	मौर्या
maurya	मौर्य	मौर्यों
mauryon	मौर्यों	मौर्यों
moryon	मोर्नों	मौर्यों
maulaviyon	मौलवियों	मौलवियों
maulvidon	माल्विडों	मौलवियों
maulviyon	मौलवियों	मौलवियों
maule	मौले	मौले
mauley	मौले	मौले
mausa	मौसा	मौसा
yatn	यतन	यत्न
yatna	यतना	यत्न
yada	यादा	यदा
yda	एडा	यदा
yaduvansh	याद्वंस	यदुवंश
yaduwansh	याद्वंस	यदुवंश
jerusalem	जररससलल	यरूशलेम
yarooshaleim	यारोशललम	यरूशलेम
yarushalem	यारुशललम	यरूशलेम
yashpaal	यशसपल	यशपाल
yashpal	यशप्ल	यशपाल
yaatna	यातना	यातना
yatna	यतना	यातना
yaatanaon	यातानाओं	यातनाओं
yatnaon	यतनाओं	यातनाओं
yarayan	यायान	यात्राएं
yatraein	यात्राएं	यात्राएं
yatraen	यात्राएं	यात्राएं
yaariyan	यारियां	यारियां
yariyan	यारियां	यारियां
yaari	यारी	यारी
yari	यारी	यारी
yugam	युगम	युग्म
yugm	युग्म	युग्म
yuddhrat	युद्धात	युद्धरत
yudhrat	युद्रात	युद्धरत
ukrainian	उक्रेनियन	यूक्रेनियन
ukranian	उक्राणियां	यूक्रेनियन
jerusalem	जररससलल	येरुशलम
yorker	यॉर्कर	यॉर्कर
yojanaein	योजनाएं	योजनाएं
yojanaen	योजनाएं	योजनाएं
yojanaye	योजनाए	योजनाएं
rangate	रंगते	रंगते
rangte	रंगते	रंगते
rangkata	रंगकता	रंजकता
ranjkatha	रणजकता	रंजकता
ranjkta	रणजकता	रंजकता
raees	राईस	रईस
rais	राईस	रईस
raktaabh	रक्तभाभ	रक्ताभ
raktabh	रक्तभ	रक्ताभ
rakhna	रखना	रखना
raghupati	रघुपति	रघुपति
raghuram	रघुरम	रघुराम
registerd	रिजिस्टर्ड	रजिस्टर्ड
registered	रिजिस्टेड	रजिस्टर्ड
ratanpur	रतनपुर	रतनपुर
runners	नर्नस	रनर्स
rayan	रायन	रयान
ryan	रायन	रयान
ralhan	रालहण	रल्हन
ravish	रविश	रविश
ravael	रवाल	रवैल
ravel	रवेल	रवैल
rawail	रवाल	रवैल
rasad	रसाद	रसद
rasaayanik	रसायानिक	रसायनिक
rasaayanika	रसायानिका	रसायनिक
rasayanika	रसायनिका	रसायनिक
rasyanik	रास्यानिक	रसायनिक
rasaayanon	रसायाओं	रसायनों
rasayanon	रसायाओं	रसायनों
rahamat	रहमत	रहमत
rahmat	रहमत	रहमत
rhamat	रहमत	रहमत
rahenge	रहेंगे	रहेंगे
rahegi	रहेगी	रहेगी
rounder	राउंडर	राउंडर
raak	राक	राक
rak	रक	राक
raakhe	राखे	राखे
rakhe	रखे	राखे
raagon	रागों	रागों
ragon	रागों	रागों
raghavan	रघवां	राघवन
raaj	राज	राज
raj	रज	राज
rajkot	राजकोत	राजकोट
rajtantra	राजतंत्र	राजतंत्र
raajneetikaran	राजनीतिकारण	राजनीतीकरण
rajneetikaran	राजनीतिकरण	राजनीतीकरण
rajnitikaran	राजनीतिकरण	राजनीतीकरण
rajma	राजमा	राजमां
rajman	रामान	राजमां
raajasva	राजसवव	राजस्व
rajasva	राजस्व	राजस्व
raaji	राजी	राजी
raji	राजी	राजी
rajinaama	रजीनामा	राजीनामा
rajinama	रजीनमा	राजीनामा
raajon	राजों	राजों
rajon	राजों	राजों
rana	राना	राणा
raatrichar	रात्चिरार	रात्रिचर
ratrichar	रत्चिरार	रात्रिचर
raadhe	राधे	राधे
radhe	राधे	राधे
ranapur	रानपुर	रानापुर
rabin	रबीन	राबिन
robin	रोबीन	राबिन
rabha	राभा	राभा
ramkot	रामकोट	रामकोट
ramkote	रामकोट	रामकोट
ramtek	रामतेक	रामटेक
rampur	रामपुर	रामपुर
rambharose	रामभोरेस	रामभरोसे
rambharosey	रामभोरे	रामभरोसे
ramraj	रामाज	रामराज
raalod	रालोड	रालोद
ralaud	रालाद	रालोद
ralod	रालोड	रालोद
ravaley	रवाले	रावले
ravle	राले	रावले
rasayanik	रसायनिक	रासायनिक
racreation	रेक्रियन	रिक्रिएशन
recreation	रिक्रेशन	रिक्रिएशन
rig	राज	रिग
riggs	रिग्स	रिग्स
rigs	रिज्स	रिग्स
richual	रिचुल	रिचुअल
ritual	रितुल	रिचुअल
reduction	रेडिक्शन	रिडक्शन
ripan	रिपन	रिपन
ripon	रिपों	रिपन
ria	राई	रिया
riya	रिया	रिया
rishte	रिश्ते	रिश्ते
rishtey	रिश्ते	रिश्ते
risane	रिसने	रिसने
risaney	रिसने	रिसने
risne	रिसने	रिसने
rihana	रिहाना	रिहाना
rihanna	रिहनाना	रिहाना
regal	रेगल	रीगल
rigal	रिगल	रीगल
reasonal	रिसोलल	रीजनल
regional	रेजिनल	रीजनल
retreate	रिट्रेट	रीट्वीट
retweet	रित्वित	रीट्वीट
reeta	रीता	रीता
rita	रीता	रीता
rukate	रुकते	रुकते
rukte	रुक्ते	रुकते
ruktey	रुक्ते	रुकते
rugan	रुगन	रुग्ण
rugna	रूगना	रुग्ण
ruganta	रुगंतता	रुग्णता
rugnata	रूगनता	रुग्णता
rojvelt	रोजवेल्ट	रुजवेल्ट
roojwelt	रूजवेल्ट	रुजवेल्ट
roosevelt	रूसेवेल्ट	रुजवेल्ट
rodolph	रोड़ोफ	रुडोल्फ
rudolf	रूडोल्फ	रुडोल्फ
rudolph	रूडोल्फ	रुडोल्फ
roopesh	रूपेश	रुपेश
rupesh	रूपेश	रुपेश
ruby	रबबी	रुबी
roomani	रूमानी	रुमानी
rumani	रूमानी	रुमानी
rukavaton	रुकवातों	रूकावटों
root	रूत	रूट
route	रौउते	रूट
rooting	रूटिंग	रूटिंग
routine	रॉटिन	रूटिंग
routing	रॉटिंग	रूटिंग
roots	रूट्स	रूट्स
routes	रॉट्स	रूट्स
roopak	रूपक	रूपक
rupak	रुपक	रूपक
roopi	रूपी	रूपी
rupi	रूपी	रूपी
rantle	रंटल	रेंटल
rental	रेंटल	रेंटल
registan	रेजिस्टन	रेगिस्तान
registani	रेजिस्टनी	रेगिस्तानी
reja	रेजा	रेजा
reza	रेजा	रेजा
rate	रते	रेट
rate	रते	रेत
ret	रेट	रेत
refaeli	रेफली	रेफेली
refeli	रेफली	रेफेली
reshe	रेशे	रेशे
reshey	रेशे	रेशे
race	रास	रेस
rese	रेस	रेस
racer	रेसर	रेसर
recer	रीसर	रेसर
racing	रेसिंग	रेसिंग
reson	रेसों	रेसों
rehaana	रेहाना	रेहाना
rehana	रेहना	रेहाना
racketeer	रककीट	रैकेटियर
racketier	रेकेटियर	रैकेटियर
rectare	रिक्टेरर	रैकेटियर
radical	रेडिकल	रैडिकल
raidical	रेडिकल	रैडिकल
raith	राथ	रैथ
rapping	रापिंग	रैपिंग
wrapping	वर्पिंग	रैपिंग
robertsan	रॉबर्टन	रॉबर्टसन
robertson	रॉबर्सन	रॉबर्टसन
robinson	रोबिंसन	रॉबिंसन
royals	रोयल्स	रॉयल्स
rojlin	रोजलीन	रोजलिन
rozlyn	रोजलीन	रोजलिन
rotation	रोटेशन	रोटेशन
rodrigo	रोड्रिगो	रोड्रिगो
ronaldo	रोनालोड	रोनाल्डो
ronit	रोनिट	रोनित
roni	रोनी	रोनी
ropane	रोपने	रोपने
ropaney	रोपने	रोपने
ropne	रोपने	रोपने
robin	रोबीन	रोबिन
roya	रोया	रोया
rollers	रॉल्स	रोलर्स
rovan	रोवन	रोवन
rowan	रोवन	रोवन
rosario	रोसरियो	रोसारियो
rosariyo	रोसरियों	रोसारियो
raubadaar	रूबादार	रौबदार
raubadar	रुबादार	रौबदार
raubdar	रौबदार	रौबदार
landara	लंदरा	लंगड़ा
langada	लंगड़ा	लंगड़ा
langda	लंगड़ा	लंगड़ा
langar	लंगर	लंगर
langaron	लंगरों	लंगरों
langron	लंगरों	लंगरों
lambi	लंबी	लंबी
lakeer	लकीर	लकीर
lakir	लाकिर	लकीर
lakiron	लाकिरों	लकीरों
lakme	लकमे	लक्मे
lakshmidhar	लक्ष्मीदार	लक्ष्मीधर
lakshmighar	लक्ष्मीघर	लक्ष्मीधर
lakshy	लक्ष्य	लक्ष्य
lakshya	लक्ष्य	लक्ष्य
lakshyon	लक्ष्यों	लक्ष्यों
lux	लॉक्स	लक्स
laksar	लकस्र	लक्सर
luxor	ल्योकर	लक्सर
lakhkhi	लखखखी	लख्खी
lagna	लगना	लगना
laganewale	लगानेवाले	लगनेवाले
lagnevaaley	लगनेवाले	लगनेवाले
lagnewale	लगनेवाले	लगनेवाले
lagega	लगेगा	लगेगा
lajjalu	लजजालू	लज्जालु
latkate	लटकते	लटकाते
ladki	लड़की	लड़की
ladate	लड़ते	लड़ते
ladte	लड़ते	लड़ते
ladaai	लड़ाई	लड़ाई
ladai	लड़ाई	लड़ाई
ladaaiyon	लड़ाइयों	लड़ाईयों
ladaeyon	लड़ायाओं	लड़ाईयों
ladaiyon	लाड़ियों	लड़ाईयों
lapetane	लपपेटने	लपेटने
lapetne	लपपेटन	लपेटने
labada	लबड़ा	लबादा
lbada	लबड़ा	लबादा
labdh	लाभद	लब्ध
lbdh	एल्बी	लब्ध
lalak	लाक	ललक
lalkarata	ललकरता	ललकारता
lalkarta	लाक्रता	ललकारता
lalla	लाला	लल्ला
lavasa	लवासा	लवासा
lovasa	लोवासा	लवासा
lassi	लासी	लस्सी
lahanaa	लहना	लहना
lahna	लहना	लहना
lehna	लहना	लहना
lahraee	लहराई	लहराई
lahrai	लहराई	लहराई
lehrayi	लहरायी	लहराई
lahalhati	लहलाहती	लहलहाती
lahlahaati	लहलाहती	लहलहाती
lahlahati	लहलाहती	लहलहाती
lahsun	लहसून	लहसुन
lasoon	लसून	लहसुन
lanchar	लांचर	लांचर
launcher	लाउंचर	लांचर
lycopene	लाइपोने	लाइकोपिन
lime	लाइम	लाइम
lives	लाइवस	लाइव्स
live	लाइव	लाईव
laegi	लागी	लाएगी
lagataar	लगातार	लागातार
lagatar	लगातर	लागातार
laata	लाता	लाता
lata	लटा	लाता
laati	लाती	लाती
lati	लटी	लाती
layega	लाएगा	लायेगा
lalpur	लापुर	लालपुर
las	लास	लास्ट
last	लस्त	लास्ट
lindbhed	लिंडेद	लिंगभेद
lingbhed	लिंगेद	लिंगभेद
lindan	लिंडन	लिंडन
lindn	लिंडन	लिंडन
lindon	लिंडों	लिंडन
likhakar	लिखाकार	लिखकर
likhkar	लिखकर	लिखकर
ligar	लाइगर	लिगर
liger	लाइजर	लिगर
liberation	लाइबरेशन	लिबरेशन
libration	लाइब्रेशन	लिबरेशन
liberation	लाइबरेशन	लिब्रेशन
libration	लाइब्रेशन	लिब्रेशन
leaderon	लेडरों	लीडरों
leedaron	लीड़ारों	लीडरों
lidaron	लिड़ारों	लीडरों
liidaron	लिड़ारों	लीडरों
louis	लोइस	लुईस
luis	लुस	लुईस
ludhakate	लुढ़कते	लुढ़कते
ludhkate	लुड़कते	लुढ़कते
lurhakate	लुराकते	लुढ़कते
lutf	लूट	लुत्फ
lumding	ल्मंडिंग	लुमडिंग
lootmaar	लूटमार	लूटमार
lootmar	लूटमर	लूटमार
landal	लंडल	लेंडल
lendal	लेंडल	लेंडल
lega	लेगा	लेगा
legaa	लेगा	लेगा
letakar	लेटककर	लेटकर
letkar	लेटकर	लेटकर
lenevali	लेनेवाली	लेनेवाली
lenewali	लेनेवाली	लेनेवाली
label	लेबल	लेबल
labeling	लेबिंग	लेबलिंग
labelling	लेबललिंग	लेबलिंग
labelo	लेबलल	लेबलों
labelon	लेबलों	लेबलों
lebalon	लेबलों	लेबलों
lemon	लेमों	लेमन
laingadan	लैंगाडन	लैंगडन
langdon	लंगड़ों	लैंगडन
lengdan	लेंगड़न	लैंगडन
laigikata	लैगिकता	लैंगिकता
laingikta	लैंगिकता	लैंगिकता
lanset	लांसेट	लैंसेट
lenset	लेंसेट	लैंसेट
lairi	लैरी	लैरी
lairy	लैरी	लैरी
larry	लेरी	लैरी
lace	लेस	लैस
less	लेस	लैस
locket	लॉकेट	लॉकेट
laundry	लॉन्ड्री	लॉन्ड्री
longewal	लोंजेवल	लोंगोवाल
longewala	लोंगेवाला	लोंगोवाल
longoval	लोंगोवल	लोंगोवाल
log	लोग	लोग
loge	लोग	लोगे
lochdar	लोचदार	लोचदार
lodi	लोडी	लोदी
laurence	लॉरेंस	लौरेंस
laurens	लॉर्स	लौरेंस
laurense	लॉर्ेंस	लौरेंस
wonder	वंडर	वंडर
vansh	वांश	वंश
vanshdhar	वंशधधार	वंशधर
vanshavad	वाशावाद	वंशवाद
vanshvaad	वंशावाद	वंशवाद
vanshvad	वांशवाद	वंशवाद
wanshwad	वांशवाद	वंशवाद
vajood	वजूद	वजूद
vajud	वाजुद	वजूद
wajood	वजूद	वजूद
vadali	वादली	वडाली
vadli	वादी	वडाली
wadali	वादली	वडाली
vanita	वानीता	वनिता
vareinye	वरेनीय	वरेण्य
varenya	वरेनीय	वरेण्य
varn	वार्न	वर्ण
varna	वर्न	वर्ण
varnit	वरर्नित	वर्णित
vartamaan	वर्तमान	वर्तमान
vartaman	वर्तमान	वर्तमान
vartmaan	वर््तमन	वर्तमान
vartman	वार्तमन	वर्तमान
varddhaman	वर्दमान	वर्द्धमान
vardhmaan	वर्धमान	वर्द्धमान
vardhman	वर्धमन	वर्द्धमान
verbal	वर्बल	वर्बल
varshan	वर्षण	वर्शन
vasharan	वाषरण	वर्शन
vershan	वर्शन	वर्शन
version	वर्सन	वर्शन
varsaache	वरससचचे	वर्साचे
varsaryache	वार्सेश्ची	वर्साचे
vasearche	वासेरेच	वर्साचे
valkan	वाकन	वल्कन
valkkan	वाक्कन	वल्कन
velkan	वेलकन	वल्कन
vash	वाष	वश
vashikaran	वाषीकरण	वशीकरण
vaangchuk	वांगचुक	वांगचुक
vangchuk	वांचुुक	वांगचुक
wangchuk	वांचुक	वांगचुक
want	वांट	वांट
vije	वाइज	वाइज
vise	वाइस	वाइज
wise	वाइस	वाइज
vatar	वातर	वाटर
water	वेटर	वाटर
watson	वाटसन	वाटसन
wattson	वाट्सन	वाटसन
vaan	वान	वाण
waan	वान	वाण
vaanon	वानों	वाणों
vanon	वानों	वाणों
wanon	वानों	वाणों
vatanukulan	वातनुकुलन	वातानुकूलन
watanukoollan	वातनुकुललन	वातानुकूलन
vaadak	वादक	वादक
vadak	वादक	वादक
vaadiyon	वादियों	वादियों
vadiyon	वादियों	वादियों
wadiyon	वादियों	वादियों
vayana	वायना	वायना
vayna	वायना	वायना
wayna	वायना	वायना
wireless	वायरेस्स	वायरलेस
wirerless	वारेलर्स	वायरलेस
warrior	वारीयर	वारियर्स
warriors	वार्यर्स	वारियर्स
valve	वाल्वे	वाल्व
wolv	वॉल्वी	वाल्व
vastavik	वास्तविक	वास्तविक
vastvik	वास्तविक	वास्तविक
vaahikayen	वाहिकाएं	वाहिकाएं
vahikayen	वाहिकाएं	वाहिकाएं
wahikayan	वाहिकाएं	वाहिकाएं
winter	वाइटर	विंटर
vincent	विंसेंट	विंसेंट
vikalpon	विकल्पों	विकल्पों
wicket	विकेट	विकेट
vikramjeet	विक्रममजित	विक्रमजीत
vikramjit	विक्रममित	विक्रमजीत
vichaarakon	विचारकों	विचारकों
vicharakon	विचारकों	विचारकों
vigyan	विज्ञान	विज्ञान
vigyaani	विज्ञानी	विज्ञानी
vigyani	विज्ञानी	विज्ञानी
vigyaanon	विज्ञानों	विज्ञानों
vigyanon	विज्ञानों	विज्ञानों
vitthal	वित्थल	विट्ठल
viththal	विथ्ल	विठ्ठल
vitthal	वित्थल	विठ्ठल
vitark	वितरक	वितर्क
vidhaaein	विधाएं	विद्याएं
vidyaayein	विद्याएं	विद्याएं
vidyaen	विद्याएं	विद्याएं
vidhaaon	विधाओं	विद्याओं
vidyaaon	विद्याओं	विद्याओं
vidyaon	विद्याओं	विद्याओं
vidhansabhaein	विधानंभाएं	विधानसभाएं
vidhansabhaen	विधानंभाएं	विधानसभाएं
vidhivat	विधिवत	विधिवत
vidhut	विधुत	विधुत
vinasht	विनाष्ट	विनष्ट
vineet	विनीत	विनीत
vinit	विनित	विनीत
vipreetataa	विप्रतिता	विपरीतता
vipritata	विपरतिता	विपरीतता
vipra	विप्र	विप्रा
vipro	विप्रो	विप्रो
wipro	वाप्रो	विप्रो
vibha	विभा	विभा
vibhajak	विभाजक	विभाजक
vibhram	विभ्रम	विभ्रम
vibhrm	विभ्रम	विभ्रम
vibram	विब्रम	विभ्रम
vimarsh	विमर्श	विमर्श
vimarsho	विमर्शों	विमर्शों
vimarshon	विमर्शों	विमर्शों
virajati	विराजती	विराजती
virechan	विरेचन	विरेचन
virodh	विरोध	विरोध
virodhabhasi	विरोधागाी	विरोधाभासी
virodhabhason	विरोभागाशन	विरोधाभासों
vividh	विविध	विविध
vivekahin	विवेकानी	विवेकहीन
vivekheen	विवेखन	विवेकहीन
visheshan	विशेषण	विशेषण
visheshanon	विशेषणों	विशेषणों
visheshaadhikaar	विशेषाधिकार	विशेषाधिकार
visheshadhikar	विशेषाधिकार	विशेषाधिकार
vishwasaniy	विश्वानीय	विश्वसनीय
vishwasniiya	विश्वसनीय	विश्वसनीय
vishwasaniyata	विश्वासनिता	विश्वसनीयता
vishwasniiyataa	विश्वसनीयता	विश्वसनीयता
vishahin	विषाहीन	विषहीन
vishhin	विष्णीन	विषहीन
vishanu	विषानु	विष्णु
vishnu	विष्णु	विष्णु
vlc	एलएसी	वीएलसी
weeks	वीक्स	वीक्स
veerchand	वीरचंद	वीरचंद
virchand	विरचंद	वीरचंद
veeresh	वीरेश	वीरेश
viresh	वेरेश	वीरेश
vritton	वृत्टों	वृत्तों
vruton	वृतों	वृत्तों
vrutton	वृत्तों	वृत्तों
venkataraman	वेंकटरमण	वेंकटरमन
venkatraman	वेंकटरममन	वेंकटरमन
ved	वेद	वेड
wade	वादे	वेड
wed	वेद	वेड
wedding	वेदिंग	वेडिंग
vediyon	वेदियों	वेदियों
vedon	वेदों	वेदों
venezuela	वेनेजुला	वेनेजुएला
veronica	वरोनिका	वेरोनिका
veronika	वरोनिका	वेरोनिका
weronika	वेरोनिका	वेरोनिका
velvet	वेल्टेट	वेलवेट
welwet	वेलेट	वेलवेट
welder	वेल्डर	वेल्डर
weldor	वेल्डर	वेल्डर
welding	वेलिंग	वेल्डिंग
wealth	वेल्थ	वेल्थ
vellur	वेल्यूर	वेल्लूर
velur	वेलूर	वेल्लूर
vesh	वेष	वेश
wasting	वास्टिंग	वेस्टिंग
westing	वेस्टिंग	वेस्टिंग
wastinghouse	वास्टिगुइंग	वेस्टिंगहाउस
westinghouse	वेस्टिमेंग	वेस्टिंगहाउस
vaisley	वैसली	वेस्ले
vesle	वेसले	वेस्ले
wesle	वेसले	वेस्ले
vaigyaanik	वैज्ञानिक	वैज्ञानिक
vaigyanik	वैज्ञानिक	वैज्ञानिक
vegyanik	वेजनायिक	वैज्ञानिक
vaigyaanikta	वैज्ञानियता	वैज्ञानिकता
vaigyanikata	वैज्ञनियता	वैज्ञानिकता
vaigyanikta	वैज्ञानिता	वैज्ञानिकता
vaitravati	वैत्रतवी	वैत्रवती
vaitrawati	वैत्रवती	वैत्रवती
vaimanasy	वैमानसी	वैमनस्य
vaimanasya	वैमानस्य	वैमनस्य
vaimanya	वैमान्य	वैमनस्य
very	वेरी	वैरी
vaisaakh	वैसाक	वैशाख
vaishakh	वैषाख	वैशाख
vaishaakhi	वैशाखी	वैशाखी
vaishakhi	वैशाखी	वैशाखी
vaishnodevi	वैशोनोवीदी	वैष्णोदेवी
vyaktigat	व्यक्तित	व्यक्तिगत
vyagr	व्यगग	व्यग्र
vyagra	व्यगग्र	व्यग्र
vyatit	व्यतित	व्यतीत
vytit	वातित	व्यतीत
vyabhichar	व्यभचिचार	व्यभिचार
vyabhichari	व्यभचिरी	व्यभिचार
vyavadhan	व्याधन	व्यवधान
vyavdhan	व्याधन	व्यवधान
vyavahargat	व्यावगरहात	व्यवहारगत
vyvhargat	व्यवहग्रत	व्यवहारगत
vyaghat	व्यागत	व्याघात
vyapak	व्यापक	व्यापक
vlad	व्लाद	व्लाद
wlaad	वालाद	व्लाद
vladimir	व्लाडिमियर	व्लादिमीर
shanghai	शांघी	शंघाई
shatpath	शत्थप	शतपथ
shanivar	शानिवार	शनिवार
shaniwar	शानीवर	शनिवार
shabana	शाबना	शबाना
shbana	श्बना	शबाना
shabdarth	शब्बर्थ	शब्दार्थ
shamadan	शमादन	शमादान
shmadan	श्मदन	शमादान
shamitabh	शमीतभ	शमिताभ
shamil	शमील	शमिल
shmil	शमील	शमिल
sharabon	शारबों	शराबों
shrabon	श्रबों	शराबों
shararat	शरात	शरारत
shrart	शर्त	शरारत
sharmana	शर्मना	शर्माना
shaharwasiyon	शहरवासियों	शहरवासियों
shahrvasiyon	शहर्वसियों	शहरवासियों
shervasiyon	श्रवेसियों	शहरवासियों
shahdara	शाहदारा	शहादरा
shaantikaal	शांतिकलल	शांतिकाल
shantikal	शांतिकल	शांतिकाल
shaao	शाओ	शाओ
shao	शाओ	शाओ
shaakir	शाकीर	शाकिर
shakir	शकीर	शाकिर
shaakhaaen	शाखाएं	शाखाएं
shakhayan	शखायां	शाखाएं
shakhayen	शखाएं	शाखाएं
shayak	शायक	शायक
shaavakon	शावकों	शावकों
shavakon	शावकों	शावकों
shavkon	शाक्वों	शावकों
shaasaka	शासका	शासक
shasak	शासक	शासक
sasakon	ससकों	शासकों
shaasakon	शासकों	शासकों
shasakon	शासकों	शासकों
shipra	शिप्र	शिप्रा
shirke	शिरके	शिर्के
sheershakon	शीर्षकों	शीर्षकों
shirshakon	शिर्षकों	शीर्षकों
shirshkon	शिर्षकों	शीर्षकों
shujaat	शुजात	शुजात
shujat	शुजत	शुजात
shooting	शूटिंग	शुटिंग
shutting	श्टुटिंग	शुटिंग
should	शौल्ड	शुड
shud	शुद	शुड
shubhankar	शुभानकर	शुभंकर
shumaali	शुमाली	शुमाली
shumali	शुमली	शुमाली
shringaar	श्रृंगार	शृंगार
shringar	श्रृंगर	शृंगार
shrungar	श्रंगर	शृंगार
sheling	शीलिंग	शेलिंग
shelling	शेलिंग	शेलिंग
shaili	शैली	शैली
shaly	शल्य	शैली
sheli	शेली	शैली
shaishav	शैशाव	शैशव
sean	सीन	शॉन
shaun	शौन	शॉन
shawn	शान	शॉन
short	शोर्त	शोर्ट
sure	सुरे	श्योर
shrankhala	श्रंखला	श्रंखला
shrankhalaa	श्रृंखला	श्रंखला
shrunkhla	श्रृंखला	श्रंखला
shrankhalaaon	श्रंखलाओं	श्रंखलाओं
shrinkhalaon	श्रृंखलाओं	श्रंखलाओं
shrunkhlaon	श्रृंखलाओं	श्रंखलाओं
shravani	श्रवानी	श्रावणी
shrikar	श्रीकार	श्रीकर
shrikhand	श्रीखंद	श्रीखंड
shrimati	श्रीमति	श्रीमति
shriram	श्रीरम	श्रीराम
sriram	श्रीरम	श्रीराम
shrotaon	श्रोताओं	श्रोताओं
shat	शत	षट्
sankhyaein	संख्याएं	संख्याएं
sankhyaen	संख्याएं	संख्याएं
sankhyayen	संख्याएं	संख्याएं
sanghanit	संघानित	संघनित
sanghnit	संघनीत	संघनित
sanchayan	संचायन	संचयन
sanchar	संचार	संचार
sanchaari	संचारी	संचारी
sanchari	संचारी	संचारी
sanchalanon	संचलनों	संचालनों
sanchalnon	संचलनों	संचालनों
sanjay	संजय	संजय
sanjeevan	संजीवन	संजीवन
sanjivan	संजीवन	संजीवन
santati	संतती	संतति
sandarbh	संदर्भ	संदर्भ
sandarbha	संदर्भ	संदर्भ
sandrbh	संद्रभ	संदर्भ
sandarbhon	संदर्भों	संदर्भों
sandrbhon	संद्रहों	संदर्भों
sandali	संडली	संदली
sandli	संडली	संदली
sandhan	सांधन	संधान
samprati	संप्रति	संप्रति
samprti	संप्रति	संप्रति
samprabhu	संपर्भु	संप्रभु
samprbhu	संपर्भु	संप्रभु
samprabhuta	संपर्भात	संप्रभुता
samprbhuta	संपर्भुत	संप्रभुता
sambit	संबीत	संबित
sambhalane	संभालने	संभालने
sambhalne	संभलने	संभालने
sambhrant	संभर्ंत	संभ्रांत
sanbharnt	संभार्त	संभ्रांत
sanyog	सायोग	संयुक्त
sanyukt	सन्युक्त	संयुक्त
sanyukta	सन्युक्त	संयुक्त
sanyukta	सन्युक्त	संयुक्ता
sanyogvash	संयोग्षास	संयोगवश
sanyojan	सन्योजन	संयोजन
sanyojanon	संयोजनों	संयोजनों
sanyojnon	सन्योजनों	संयोजनों
samvedikaran	संवेदीकरण	संवेदीकरण
sanvedikaran	संवेदीकरण	संवेदीकरण
samshayon	संशायों	संशयों
sanshayon	संशायों	संशयों
sanshyon	संश्यों	संशयों
sanskaar	संस्कार	संस्कार
sanskar	संस्कर	संस्कार
sanskaari	संस्कारी	संस्कारी
sanskari	संस्कारी	संस्कारी
sanskrit	संस्कृत	संस्कृत
sanskurt	संसकुर्त	संस्कृत
sanskritiyan	संस्कृतियां	संस्कृतियां
sanskrutiyan	संस्कृतियों	संस्कृतियां
sanskritiyon	संस्कृतियों	संस्कृतियों
sanskrutiyon	संस्कृतियों	संस्कृतियों
sanasthit	सनस्थित	संस्थित
sansthit	संस्थित	संस्थित
sanasthita	सनस्थित	संस्थिता
sansthita	संस्थित	संस्थिता
sakara	सकरा	सकरा
sakra	सकरा	सकरा
sakshan	साक्षण	सक्शन
suction	स्क्टिनन	सक्शन
sacchidanand	सच्छिदंद	सच्चिदानंद
sachhidanand	सच्छिंदंद	सच्चिदानंद
sachidanand	सचिंदांद	सच्चिदानंद
sajja	सजजा	सज्जा
sat	सत	सत
satpal	सत्पल	सतपाल
satluj	सतलुज	सतलुज
sataane	सताने	सताने
satane	सतने	सताने
sate	सते	सते
satti	सत्ती	सत्ती
satvat	सत्वत	सत्वत
sadanand	सदानंद	सदानंद
sapane	सपने	सपने
sapne	सपने	सपने
sapney	सपने	सपने
saparivaar	सपपरिवार	सपरिवार
sapariwar	सपपरियार	सपरिवार
sparivar	स्पीरवार	सपरिवार
sapaat	सपात	सपाट
sapat	सपपत	सपाट
sapate	सपते	सपाटे
sapatey	सपपते	सपाटे
saptakranti	सप्तकर्रती	सप्तक्रांति
saptkraanti	सप्तकर्रती	सप्तक्रांति
saptapadi	सप्तपादी	सप्तपदी
saptpadi	सप्पतादी	सप्तपदी
saptari	सप्तरी	सप्तरी
sapramaan	सप्रमान	सप्रमाण
sapraman	सप्रमण	सप्रमाण
submit	सब्मित	सबमिट
sabmission	सब्मिसनं	सबमिशन
submission	सब्मिसन	सबमिशन
sabhaein	सभाएं	सभाएं
sabhaen	सभाएं	सभाएं
sabhayen	सभाएं	सभाएं
sabhen	सभें	सभाएं
sabhasadon	सभासदों	सभासदों
sabhyata	सभ्यता	सभ्यता
samjhoonga	समझझगा	समझूंगा
samjhunga	समझुगा	समझूंगा
samjhungaa	समझुगा	समझूंगा
saman	सामन	समन
samanvayaka	समन्वयकक	समन्वयक
samanwayaka	समन्वयका	समन्वयक
samnvyak	साम्नवयक	समन्वयक
samaadhaan	समाधन	समाधान
samadhan	समाधन	समाधान
samadhiyon	समाधियों	समाधियों
samadjiyon	समाज़ियों	समाधियों
samalakha	समलाखा	समालखा
samalakhaa	समलाखा	समालखा
samahaar	समहार	समाहार
samahar	समहहार	समाहार
samitiyan	समीतियां	समितियां
sametati	समेतती	समेटती
sametti	समेत्ती	समेटती
sarka	सर्का	सरका
sarkaa	सरका	सरका
sarkarein	सरकररें	सरकारें
sarkaren	सर्करें	सरकारें
sarkaaron	सरकारों	सरकारों
sarkaron	सरकरों	सरकारों
sargana	सर्गना	सरगना
sarganaon	सर्गानों	सरगनाओं
sargi	सरगी	सरगी
sarguja	सरगगज़ा	सरगुजा
sarjuga	सर्जगु	सरगुजा
sarsa	सरससा	सरसा
sarsaa	सरसा	सरसा
sarahind	सराहिंद	सरहिंद
sarhind	साहींद	सरहिंद
sirhind	सिरहंद	सरहिंद
saraaha	सराहा	सराहा
saraha	सरहह	सराहा
saraahi	सराही	सराही
sarahi	सरहही	सराही
salaahkar	सलाहकार	सलाहकार
salahkaar	सलाहकार	सलाहकार
salahkar	सलाहकार	सलाहकार
saleeb	सालीब	सलीब
salib	सालीब	सलीब
select	सेलेक्ट	सलेक्ट
saltanat	सल्टनात	सल्तनत
saltnat	सललतनत	सल्तनत
savaal	सवाल	सवाल
saval	सववल	सवाल
sawaal	सवाल	सवाल
sawal	सवाल	सवाल
sahakalaakar	सहकलककर	सहकलाकार
sahakalakar	सहकलककर	सहकलाकार
sahkalakar	सहकलाकार	सहकलाकार
sahadev	सहादेव	सहदेव
sahdev	सहदेव	सहदेव
sahrawat	सहरावत	सहरावत
sherawat	शेरावत	सहरावत
sahooliyata	सहलियताता	सहूलियत
sahuliyat	सहलियतत	सहूलियत
sahuuliyata	सहुलियता	सहूलियत
saanketika	सांकेकिता	सांकेतिक
sanketik	संकेकित	सांकेतिक
saimans	सैमास	साइमंस
simmons	साममंस	साइमंस
symons	सायमंस	साइमंस
saima	सैमा	साइमा
sagarika	सगारिका	सागरिका
sagrika	सगगरिका	सागरिका
saga	सगा	सागा
saajan	साजन	साजन
sajan	सजन	साजन
saajsajja	साजजजसा	साजसज्जा
sajsajja	सजजजजा	साजसज्जा
saja	सजा	साजा
saathsaath	साठसाथ	साथसाथ
sathsath	सथस्थ	साथसाथ
sathiya	साठिया	साथिया
saabah	सााह	साबाह
sabah	सबाह	साबाह
samanjasy	समाजसस्ञ	सामंजस्य
samanjasya	समाजनस्य	सामंजस्य
samoa	समो	सामोआ
samoaa	समोा	सामोआ
saayn	सायन	सायं
sayan	सायन	सायं
saym	सायम	सायं
saira	सैरा	सायरा
sayara	सायरा	सायरा
sayra	सायरा	सायरा
salve	सलवे	साल्वे
sahab	सहाब	साहब
singapore	सिंगपरर	सिंगापुर
singaar	सिंगार	सिंगार
singar	सिंगर	सिंगार
singer	सिंगर	सिंगार
singhaadey	सिंहड़े	सिंघाड़े
singhade	सिंहड़े	सिंघाड़े
singhde	सिंहदे	सिंघाड़े
singhre	सिंहरे	सिंघाड़े
singhi	सिंही	सिंघी
singha	सिंहा	सिंहा
sinha	सिंहा	सिंहा
siera	सीरा	सिएरा
sierra	सिररा	सिएरा
sikud	सिकुड़	सिकुड़
signals	सिग्नल्स	सिगनल्स
cigaretton	सिगेरेट्टन	सिगरेटों
cigretton	सिग्रेटों	सिगरेटों
siddhivat	सिद्धिवत	सिद्धवट
siddhvat	सिद्धवत	सिद्धवट
siddhwat	सिद्धवत	सिद्धवट
sinabang	सिनाबंग	सिनाबंग
synapse	सिनापसे	सिनेप्स
sipah	सिपा	सिपाह
sipaha	सिपाहा	सिपाह
sipahiyon	सिपाहियों	सिपाहियों
sipahi	सिपाही	सिपाही
sim	सीम	सिम
simat	सीमत	सिमट
simatataa	सीमतता	सिमटता
simatta	सिमततता	सिमटता
simtata	सिमतता	सिमटता
simtataa	सिमतता	सिमटता
cement	सेमेंट	सिमटे
simate	सीमते	सिमटे
simi	सीमी	सिमी
simmy	सिम्मी	सिमी
sims	साइस	सिम्स
siyasi	सियसी	सियासी
siyah	सियाह	सियाह
siyaha	सियाहा	सियाह
sirpur	सिरपुर	सिरपुर
sivan	सीवन	सिवान
siwan	सीवन	सिवान
sisva	सिस्वा	सिसवा
siswa	सिस्वा	सिसवा
cil	सील	सीआईएल
csi	सीसी	सीएसआई
sikar	सिकर	सीकर
seaten	सीटन	सीटें
sitaram	सीतरम	सीताराम
sitaharan	सीताहान	सीताहरण
cpm	सीपीएम	सीपीएम
cps	सीपीएस	सीपीएस
cbse	सीबीएस	सीबीएसई
seem	सीम	सीम
sim	सीम	सीम
sealed	सीलेड	सील्ड
shield	शील्ड	सील्ड
ccd	सीडीडी	सीसीडी
sugamata	सुगमता	सुगमता
sugmta	सुग्मता	सुगमता
sujan	सुजन	सुजेन
sujen	सूजें	सुजेन
suken	सूकें	सुजेन
sujain	सुजाएं	सुजैन
sujhaati	सुझाती	सुझाती
sujhati	सुझती	सुझाती
sutali	सुतली	सुतली
sutli	सूली	सुतली
suta	सूता	सुता
sdueep	स्पीप	सुदीप
sudip	सुपीद	सुदीप
sudhaargrah	सुधारगग्रह	सुधारगृह
sudhargrih	सुधारगही	सुधारगृह
sudhargruh	सुधारगुह	सुधारगृह
sunaaron	सुनारों	सुनारों
sunaron	सुनारों	सुनारों
sunaseer	सुनसीर	सुनासीर
sunasir	सुनासीर	सुनासीर
suneeti	सुनीती	सुनीति
suniti	सुनिती	सुनीति
sunega	सुनेगा	सुनेगा
suneyga	सुनेगा	सुनेगा
superhit	सुपरिहित	सुपरहिट
supachy	सुपच्चीय	सुपाच्य
supachya	सुपच्य	सुपाच्य
supachye	सुपचचय	सुपाच्य
subhaay	सुभाय	सुभाय
subhay	सुभाय	सुभाय
surveen	सूर्वीन	सुरवीन
survin	सूर्विन	सुरवीन
surana	सुराना	सुराणा
sulkhan	सुलखन	सुलखान
suljaayi	सुलझाय	सुलझाई
suljayi	सुलझाई	सुलझाई
suljhai	सुलझाई	सुलझाई
sulzai	सुलझाई	सुलझाई
sultana	सूल्तना	सुलताना
sulaati	सुलाती	सुलाती
sulati	सुलती	सुलाती
susanskrit	सससनसककृत	सुसंस्कृत
susanskrut	सससनसकुत्त	सुसंस्कृत
suhagin	सुहागीन	सुहागिन
soond	सूंड	सूंड़
sund	संंड	सूंड़
suiyan	सुयान	सूइयां
sukhati	सुखती	सूखती
sukhti	सूखती	सूखती
sukhakar	सुखकर	सूखाकर
soochak	सूचक	सूचक
suchak	सूचक	सूचक
sooja	सूजा	सूजा
suja	सुजा	सूजा
suba	सुबा	सूबा
sube	सबे	सूबे
sooraj	सूराज	सूरज
suraj	सुराज	सूरज
surinaam	सुरिनाम	सूरीनाम
surinama	सुरिनामा	सूरीनाम
suriname	सुरिनाम	सूरीनाम
suryadev	सूर्यदेव	सूर्यदेव
sendha	सेंधा	सेंधा
senvai	सेनवाई	सेंवई
sevai	सेवाई	सेंवई
sensing	सेंसिंग	सेंसिंग
sexual	सेक्सूल	सेक्सुअल
saturday	सतुर्दय	सेटरडे
seti	सेती	सेटी
seto	सेटो	सेटो
seth	सेठ	सेथ
safety	सफेेटी	सेफ्टी
semen	सेमेन	सेमिन
semin	सेमिन	सेमिन
self	सेल्फ	सेल्फ
selfie	सेल्फी	सेल्फी
save	सेवे	सेव
sev	सेव	सेव
sevakon	सेवकों	सेवकों
sevkon	सेवकों	सेवकों
samuels	सम्यूल्स	सैम्युल्स
celery	सेलरी	सैलरी
salary	सलारी	सैलरी
sakar	साकर	सॉकर
socar	सोकर	सॉकर
soccer	सॉक्सर	सॉकर
songs	सोंग्स	सॉन्ग्स
solicitor	सोलीसिटर	सॉलिसिटर
sochane	सोचने	सोचने
sochne	सोचने	सोचने
sonu	सोनू	सोनू
soma	सोमा	सोमा
spma	स्पाम	सोमा
somi	सोमी	सोमी
soy	सोए	सोय
soya	सोया	सोया
solitaire	सोलीटारेयर	सोलिटेयर
soharai	सोहराई	सोहराई
sohrai	सोहराई	सोहराई
sohaval	सोहवाल	सोहावल
sohawal	सोहवल	सोहावल
saunpane	सौंपने	सौंपने
sonpne	सोन्पे	सौंपने
scala	स्कला	स्काला
skala	स्कला	स्काला
ski	स्की	स्की
scootaron	स्कूटरों	स्कूटरों
scooteron	स्कूटरों	स्कूटरों
skootaron	स्कूतोों	स्कूटरों
scandinavia	स्केंडिनिया	स्कैंडिनेविया
scaining	स्केनिंग	स्कैनिंग
scanning	स्केनिंग	स्कैनिंग
squash	स्क्वाश	स्क्वाश
squash	स्क्वाश	स्क्वैश
skhalan	स्खलन	स्खलन
stain	स्टेन	स्टैन
stan	स्टन	स्टैन
stop	स्टोप	स्टॉप
stops	स्टोप्स	स्टॉप्स
stone	स्टोन	स्टोन
straws	स्ट्रास	स्ट्रास
stress	स्ट्रेस	स्ट्रास
stra	स्त्रा	स्ट्रे
stray	स्ट्रेय	स्ट्रे
stre	स्ट्रे	स्ट्रे
strocks	स्ट्रॉक्स	स्ट्रोक्स
strokes	स्ट्रोक्स	स्ट्रोक्स
stan	स्टन	स्तन
stanadhari	स्तनाधारी	स्तनधारी
standhaari	स्तंधारी	स्तनधारी
standhari	स्तंधारी	स्तनधारी
sthiti	स्थिति	स्तिथि
stithi	स्तीथी	स्तिथि
stuti	स्टूटी	स्तुति
sthitiyaan	स्थितियां	स्थितियां
sthitiyan	स्थितियां	स्थितियां
sthitiyon	स्थितियों	स्थितियों
sthool	स्थूल	स्थूल
sthul	स्थल	स्थूल
sthoolta	स्थुलता	स्थूलता
sthulata	स्थुलता	स्थूलता
sneakers	स्नेकर्स	स्नीकर्स
snickers	स्निकर्स	स्नीकर्स
snikarse	स्निकर्स	स्नीकर्स
spear	स्पेयर	स्पीयर
spell	स्पेल	स्पेल
spelar	स्पेलर	स्पेलर
speller	स्पेलर	स्पेलर
sprint	स्प्रिंट	स्प्रिट
sprit	स्प्रित	स्प्रिट
spray	स्प्रेय	स्प्रे
spry	स्प्री	स्प्रे
sfoorti	स्फूरती	स्फूर्ति
sfurti	स्फूर्ती	स्फूर्ति
sphoorti	स्फूर्ति	स्फूर्ति
slide	स्लाइड	स्लाइड
slider	स्लीडर	स्लाइडर
slaaidon	स्लेडियों	स्लाइडों
slidon	स्लीडों	स्लाइडों
sliders	स्लाइड्स	स्लाइड्स
slides	स्लीड्स	स्लाइड्स
slice	स्लाइस	स्लाइस
slash	स्लाश	स्लैश
swaroopon	स्वरूपों	स्वरुपों
swarupon	स्वरूपों	स्वरुपों
swa	स्वा	स्वा
swaachaalit	स्वचालित	स्वाचालित
swachalit	स्वचालित	स्वाचालित
swaarthparak	स्वात्रापकर	स्वार्थपरक
swarthparak	स्वार्तापकर	स्वार्थपरक
swiftlate	स्विफ्लेटट	स्विफ्टलेट
swiftlet	स्विफल्टट	स्विफ्टलेट
sweekarte	स्वीकेरेट	स्वीकारते
swikarte	स्वीकारेट	स्वीकारते
sweet	स्वीत	स्वीट
sweep	स्वीपप	स्वीप
sweccha	स्वेच्छा	स्वेच्छा
swecha	स्वेच्छा	स्वेच्छा
swechha	स्वेच्छा	स्वेच्छा
sweta	स्वेत	स्वेता
swap	स्वाप	स्वैप
swipe	स्वाइप	स्वैप
handiya	हंडिया	हंडिया
handiyaa	हंडिया	हंडिया
hundiya	हुंडिया	हंडिया
hakikat	हककिकत	हकीकत
haqeeqat	हकीकत	हकीकत
hathiya	हथिया	हथिया
hamala	हमाला	हमला
hamla	हमला	हमला
hamalavar	हमालवार	हमलावर
hamlavar	हमलवार	हमलावर
humlavar	हमलावर	हमलावर
hamaal	हमाल	हमाल
hamal	हमल	हमाल
hercules	हर्कल्स	हरक्यूलिस
hardas	हरदास	हरदास
harpaal	हरराल	हरपाल
harpal	हर्पल	हरपाल
harvansh	हरवांश	हरवंश
haraval	हरावल	हरावल
harawal	हरावल	हरावल
hurricane	हररिक्ना	हरिकेन
harijan	हरीजन	हरिजन
hariyali	हरियाली	हरियाली
harshit	हरशिित	हर्षित
haldi	हल्दी	हल्दी
halla	हल्ला	हल्ला
hawamahal	हवामहाल	हवामहल
hawalaat	हवालत	हवालात
hawalat	हवालत	हवालात
hasino	हसीनो	हसीनों
hasinon	हसीनों	हसीनों
haan	हान	हां
han	हान	हां
haanfte	हांचते	हांफते
hafate	हफाते	हांफते
hanfte	हंफते	हांफते
higman	हिमगन	हाइमन
hymen	हाइमेन	हाइमन
hadauti	हदाती	हाड़ौती
haani	हानी	हानी
hani	हानी	हानी
haarjeet	हारजीत	हारजीत
harjeet	हरजीत	हारजीत
haaranaa	हारणा	हारना
harana	हराना	हारना
harna	हरणा	हारना
haalchaal	हालचाल	हालचाल
haalchal	हालचल	हालचाल
halchaal	हलचल	हालचाल
halchal	हलचल	हालचाल
halt	हल्त	हाल्ट
hault	हल््ट	हाल्ट
hahakar	हहकार	हाहाकार
hingis	हिंगिस	हिंगिस
hindan	हिंदन	हिंडन
hindon	हिंडों	हिंडन
hijada	हिजाड़ा	हिजड़ा
hijda	हिजड़ा	हिजड़ा
hijbul	हिजबुल	हिजबुल
hippo	हिप्पो	हिप्पो
hippopotamus	हिप्पोजपुस्स	हिप्पोपोटेमस
himali	हिमाली	हिमाली
hilane	हिलने	हिलने
hilne	हिलने	हिलने
hisham	हिषम	हिशाम
heeraganj	हीरांगज	हीरागंज
hiraganj	हिरांगज	हीरागंज
heroes	हररोज	हीरोज
heros	हररोस	हीरोज
hui	हुई	हुईं
huin	ह्यून	हुईं
hooper	हपपर	हूपर
huppar	हपपपर	हूपर
hupper	हपपपर	हूपर
hegde	हेगडे	हेगडे
hemvati	हेमवती	हेमवती
hemwati	हेमवती	हेमवती
help	हेल्प	हेल्प
helper	हेल्पर	हेल्पर
haito	हैतो	हैतो
hairam	हैरम	हैरम
harem	हरेम	हैरम
herald	हेरलल्ड	हैराल्ड
haive	हैवे	हैव
have	हवे	हैव
hong	होंग	हॉन्ग
half	हल्फ	हॉफ
hoaf	होफ	हॉफ
hounga	हौंगा	होऊंगा
holding	हॉल्डिंग	होल्डिंग
hoshangabaad	होषंगाबाद	होशंगाबाद
hoshangabad	होषंगाबाद	होशंगाबाद
hostes	हॉस्ट्स	होस्टेस
hostess	हॉस्टेसस	होस्टेस
