latin_input	devanagari_prediction	devanagari_target
ank	अंक	अंक
anka	अंका	अंक
ankit	अंकित	अंकित
anakon	अनाकों	अंकों
ankhon	अंखों	अंकों
ankon	अंकों	अंकों
angkor	अंगको	अंकोर
ankor	अंकोर	अंकोर
angaarak	अंगारक	अंगारक
angarak	अंगरक	अंगारक
angraji	अंग्रजी	अंग्रज़ी
angreji	अंग्रेजी	अंग्रज़ी
angrzi	अंग्रजी	अंग्रज़ी
antah	अंतह	अंतः
antaha	अंतहा	अंतः
antarmukh	अंतरमुख	अंतर्मुख
antmurkh	अंतमुर्ख	अंतर्मुख
antrmukh	अंतरमुख	अंतर्मुख
andrabee	अंद्रबी	अंद्राबी
andrabi	अंद्रबी	अंद्राबी
andha	अंधा	अंधा
andhapan	अंधापन	अंधापन
andheri	अंधरी	अंधेरी
ambaani	अंबानी	अंबानी
ambani	अंबनी	अंबानी
akram	अक्रम	अकरम
acapulco	एकापुल्को	अकापुल्को
akapulko	अकपूल्को	अकापुल्को
akhand	अखंड	अखंड
akhil	अखिल	अखिल
agavai	अगवाई	अगवाई
agvaai	अगवाई	अगवाई
augustine	ऑगस्टिइन	अगस्टाइन
augustustine	ऑगस्ट्सस्टिन	अगस्टाइन
agsta	अग्सता	अगस्ता
agusta	अगुस्त	अगस्ता
augusta	औगसस्त	अगस्ता
agr	अग्र	अग्र
agra	अग्र	अग्र
achambha	अचंभा	अचंभा
achanbha	अचंभा	अचंभा
achievement	अचिइवमेंट	अचीवमेंट
achivement	अचिवेमेंट	अचीवमेंट
acchi	अच्छी	अच्छी
achchi	अच्छी	अच्छी
achhi	अछ्छी	अच्छी
achyut	अच्युत	अच्युत
achhanera	अछ्हेरा	अछनेरा
achnera	अचनेरा	अछनेरा
ajmeedh	अजमीदध	अजमीढ़
ajhar	अझार	अजहर
azhar	अझार	अजहर
ajit	अजित	अजित
agnat	अग्ञत	अज्ञात
agyaat	अज्ञात	अज्ञात
agyat	अज्ञात	अज्ञात
atakta	अतकता	अटकता
atkata	अतकता	अटकता
atake	अतके	अटके
atke	अतके	अटके
atwaal	अतवाल	अटवाल
atwal	अतवाल	अटवाल
attahasa	अत्थासा	अट्टहास
atthaas	अत्थास	अट्टहास
atthas	अत्थास	अट्टहास
addon	एड़ों	अड्डों
athak	अथक	अथक
atharv	अथरव	अथर्व
atharva	अथरवा	अथर्व
adad	अदाद	अदद
adaani	अदानी	अदाणी
adani	अदानी	अदाणी
advait	अद्वैत	अद्वैत
adwait	अद्वैत	अद्वैत
advaitvaad	अदवातवाद	अद्वैतवाद
advaitwad	अदवातवाद	अद्वैतवाद
adhivas	अधिवास	अधिवास
adhiwas	अधिवास	अधिवास
advivas	अद्विवास	अधिवास
adhiik	अधिक	अधीक
adhik	अधिक	अधीक
adhyayanarat	अध्यायनरत	अध्ययनरत
adhyayanrat	अध्यायनरत	अध्ययनरत
adhyaynrat	अध्यायरात	अध्ययनरत
anant	अनंत	अनंत
ananti	अनंती	अनंती
angadh	अंगढ़	अनगढ़
angarh	अंगढ़	अनगढ़
anchahe	अंचाहे	अनचाहे
anthak	अंथक	अनथक
unthak	उंथक	अनथक
anhoni	अन्होनी	अनहोनी
anaavashyak	अनावश्यक	अनावश्यक
anavashyak	अनावा्यक	अनावश्यक
anavshyak	अनवश्यक	अनावश्यक
anawashyak	अनावा्यक	अनावश्यक
anik	अनिक	अनिक
anishwarvadi	अनिश्वरवादी	अनीश्वरवादी
anishwarwadi	अनिश्वरवादी	अनीश्वरवादी
anukoltha	अनुकोल्ठ	अनुकूलता
anukulata	अनुकुलता	अनुकूलता
anukulta	अनुकुल्ता	अनुकूलता
anuchit	अनुच्चित	अनुचित
anuprayogi	अनुप्रयोगी	अनुप्रयोगों
anuprayogon	अनुप्रयोगों	अनुप्रयोगों
anupryogon	अनुप्रयोगों	अनुप्रयोगों
anureet	अनुरीत	अनुरीत
anurit	अनुरित	अनुरीत
anuthi	अनुती	अनूठी
anudit	अनुदित	अनूदित
anyaay	अन्याय	अन्याय
anyay	अन्य	अन्याय
anyaya	अन्याया	अन्याय
apnani	अपनानी	अपनानी
aparivartanshali	अपरिवर्तनशाली	अपरिवर्तनशील
aparivartansheel	अपरिवर्तनशील	अपरिवर्तनशील
aparivartanshil	अपरिवर्तनशील	अपरिवर्तनशील
apariharya	अपरिहार्य	अपरिहार्य
aprihary	अपरिहार्य	अपरिहार्य
apriyary	अपरियार्य	अपरिहार्य
apavartit	अपवर्तित	अपवर्तित
apvartit	अपवर्तित	अपवर्तित
apvtrit	अपवत्रित	अपवर्तित
apaardarshi	अपारदर्शी	अपारदर्शी
apardarshi	अपरदर्शी	अपारदर्शी
afroj	अफरोज	अफरोज
afroz	अफरोज	अफरोज
africa	अफरिका	अफ्रीका
abbaasi	अब्बासी	अब्बासी
abbasi	अब्बासी	अब्बासी
abhimat	अभिमत	अभिमत
abhishap	अभिषप	अभिशाप
abhi	अभी	अभी
amjhera	अमझेरा	अमझेरा
amzera	अमजेरा	अमझेरा
amargad	अमरगद	अमरगढ़
amargarh	अमरगढ़	अमरगढ़
amarpaal	अमरपाल	अमरपाल
amarpal	अमरपाल	अमरपाल
amarohi	अमरोही	अमरोही
amrohi	अमरोही	अमरोही
amaanat	अमानत	अमानत
amanat	अमानत	अमानत
amanth	अमंथ	अमानत
amaanati	अमानती	अमानती
amanathi	अमानथी	अमानती
amanati	अमानती	अमानती
amavasya	अमावस्य	अमावस्या
amavsya	अमावस्य	अमावस्या
amit	अमित	अमित
amitao	अमिताओ	अमिताव
amitav	अमितव	अमिताव
amuk	अमुक	अमुक
amogh	अमोग	अमोघ
ambani	अंबनी	अम्बानी
ayodhyaanaath	अयोध्यानाथ	अयोध्यानाथ
ayodhyanaath	अयोध्यनाथ	अयोध्यानाथ
ayodhyanath	अयोध्यनाथथथ	अयोध्यानाथ
ayodhyeanath	अयोध्यानथ	अयोध्यानाथ
aradas	अरादस	अरदास
ardaas	अर्दास	अरदास
ardas	अर्दास	अरदास
arabab	अरबब	अरबाब
arbab	अरबब	अरबाब
around	आरुंड	अराउंड
arjent	अर्जेंट	अर्जेंट
urgent	यर्जेंट	अर्जेंट
arth	अर्थ	अर्थ
artha	अर्था	अर्थ
earth	एर्थ	अर्थ
earthquake	एर्थक्यूक	अर्थक्वेक
arthon	अर्थों	अर्थों
arpit	अर्पित	अर्पित
aryama	अर्यामा	अर्यमा
aryma	अर्यमा	अर्यमा
arymaa	अर्यमा	अर्यमा
alankaar	अलंकार	अलंकार
alankar	अलंकर	अलंकार
alnkaar	अलंकार	अलंकार
alankaaron	अलंकारों	अलंकारों
alankaron	अलंकारों	अलंकारों
alnkaaron	अलंकारों	अलंकारों
alnkaron	अलंकारों	अलंकारों
alagavavadi	अलाववादी	अलगाववादी
algavvadi	अलगववादी	अलगाववादी
algavwaadi	अलगववादी	अलगाववादी
alive	एलिव	अलाइव
alance	एलेंस	अलायंस
alayans	अलायंस	अलायंस
aliance	एलाइंस	अलायंस
alind	अलिंद	अलिंद
alai	अलाई	अली
ali	अली	अली
alii	अली	अली
alonso	अलोंसो	अलोंसो
aloso	अलोसो	अलोंसो
alphabet	अल्पेबट	अल्फ़ाबेट
alba	अल्बा	अल्बा
avantipur	अवंतिपुर	अवंतिपुर
awantipora	अवंतिपोर	अवंतिपुर
avaru	अवरू	अवरु
avru	अवरू	अवरु
awaru	अवारू	अवरु
avarodhak	अवरोधक	अवरोधक
avrodhak	अवरोधक	अवरोधक
avrodhk	अवरोधक	अवरोधक
avarnata	अवर्णता	अवर्णता
avarnataa	अवर्णता	अवर्णता
avranta	अवरंता	अवर्णता
avashist	अवशिस्त	अवशिष्ट
avshisht	अवशिष्ट	अवशिष्ट
awashist	अवाशिस्त	अवशिष्ट
avasthaayen	अवस्थाएं	अवस्थाएं
avsthaen	अवस्थाएं	अवस्थाएं
avsthayen	अवस्थाएं	अवस्थाएं
awasthaen	अवस्थाएं	अवस्थाएं
avi	अवी	अवि
avika	अविका	अविका
aviral	अविरल	अविरल
avirl	अविर्ल	अविरल
avishvaasniy	अविश्वासनीय	अविश्वसनीय
avishvasniy	अविश्वसनीय	अविश्वसनीय
avishvasniya	अविश्वसनीय	अविश्वसनीय
avisvasniya	अविस्वासनीय	अविश्वसनीय
aviva	अविवा	अवीवा
avaigyanic	अवैज्ञानिक	अवैज्ञानिक
avaigyanik	अवैज्ञानिक	अवैज्ञानिक
avegyanik	अवेज्ञानिक	अवैज्ञानिक
ashaktataa	अशक्तता	अशक्तता
ashktta	अश्कतता	अशक्तता
asharaphi	अशारफी	अशरफी
ashrafi	अश्रफी	अशरफी
ashariri	अशरीरी	अशरीरी
ashriri	अश्री	अशरीरी
ashrvatath	अश्रवतथथथथथ	अश्वत्थ
ashvtth	अश्वत्थ	अश्वत्थ
asamaany	असमान्य	असमान्य
asamany	असमान्य	असमान्य
asmanye	अस्मान्य	असमान्य
asaamnjsy	असामंज्य	असामंजस्य
asamanjasy	असमंजास्य	असामंजस्य
asamanjasya	असमंजास्य	असामंजस्य
asurakshit	असुरक्षित	असुरक्षित
asurkshit	असुर्क्षित	असुरक्षित
aset	असेट	असेट
asset	असेट	असेट
asvabhavik	अस्वाभाविक	अस्वभाविक
aswabhavik	अस्वाभाविक	अस्वभाविक
aswbhavik	अस्वभाविक	अस्वभाविक
ahirauli	अहिरौली	अहिरौली
item	इटीम	आइटम
items	इटीम्स	आइटम्स
idle	इडल	आइडल
idol	इडोल	आइडल
icc	आईसीसीीीीीीीी	आइसीसी
iso	आईसो	आइसो
ipc	आईपीसीीीीीीीी	आईपीसी
ipad	इपाद	आईपैड
iris	आईरिस	आईरिस
ounce	ऑंस	आउंस
aakaash	आकाश	आकाश
aakash	आकाश	आकाश
aake	आके	आके
aakhet	आखेत	आखेट
akhet	अखेत	आखेट
aagat	आगत	आगत
aagaman	आगमन	आगमन
aagman	आगमन	आगमन
aagaa	आगा	आग़ा
aagah	आगाह	आग़ा
agha	अघा	आग़ा
aagaashe	आगाशे	आगाशे
aagashe	आगशे	आगाशे
agashe	अगशे	आगाशे
aajmaanaa	आजमाना	आजमाना
aajmana	आजमाना	आजमाना
aazmaanaa	आजमाना	आजमाना
aata	आता	आटा
ata	अता	आटा
atta	अत्ता	आटा
aatmayen	आत्मयें	आत्माएं
atmaen	अत्माएं	आत्माएं
aadaan	आदान	आदान
aadan	आदन	आदान
aadhaarit	आधारित	आधारित
aadharit	आधारित	आधारित
adharit	अधारित	आधारित
aadheen	आधीन	आधीन
aadhin	आधीन	आधीन
aadhunik	आधुनिक	आधुनिक
aanad	आनाद	आनद
aanand	आनंद	आनद
anand	अनंद	आनद
aapka	आपका	आपका
aapkaa	आपका	आपका
aapadaaaen	आपदाएं	आपदाएं
aapdaein	आपदाएं	आपदाएं
aapdayein	आपदाएं	आपदाएं
aabantit	आबंतित	आबंटित
abantit	अबंतित	आबंटित
aabru	आब्रु	आबरू
abaru	अबरू	आबरू
aamdan	आमदन	आमदन
amadan	अमान	आमदन
aamdani	आमदानी	आमदनी
amadani	अमादनी	आमदनी
aamdi	आमदी	आमदी
amdi	अमदी	आमदी
aamod	आमोद	आमोद
amod	अमोद	आमोद
aayenge	आएंगे	आयेंगे
aayojak	आयोजक	आयोजक
ro	रो	आरओ
rp	आरपीी	आरपी
aaraam	आराम	आराम
aaram	आराम	आराम
aram	अराम	आराम
aarushi	आरुशी	आरुषि
arushi	अरुशी	आरुषि
artery	अर्टीी	आर्टरी
order	ऑर्डर	आर्डर
aary	आर्य	आर्य
aarya	आर्य	आर्य
arya	अर्य	आर्य
aaryika	आर्यिका	आर्यिका
aryika	अर्यिका	आर्यिका
aarya	आर्य	आर्यो
arya	अर्य	आर्यो
aryo	अर्यो	आर्यो
aaryan	आर्यन	आर्यों
arya	अर्य	आर्यों
aryon	अर्यों	आर्यों
aalsi	आलसी	आलसी
alasi	अलासी	आलसी
aalochak	आलोचक	आलोचक
alochak	अलोचक	आलोचक
aalochakon	आलोचकों	आलोचकों
alochakon	अलोचकों	आलोचकों
aalha	आल्हा	आल्हा
aalhaa	आल्हा	आल्हा
alha	अल्हा	आल्हा
allah	अल्हाह	आल्हा
aawaazen	आवाजें	आवाज़ें
aawajen	आवाजें	आवाज़ें
awaazen	अवाजें	आवाज़ें
awazen	अवाजें	आवाज़ें
aawajon	आवाजों	आवाज़ों
aawazon	आवाजों	आवाज़ों
awaazon	अवाजों	आवाज़ों
awazon	अवाजों	आवाज़ों
aavishakaar	आविषाकार	आविष्कार
aavishkaar	आविष्कार	आविष्कार
avishkar	अविष्कार	आविष्कार
aavriti	आवृति	आवृत्ति
aavritti	आवृत्ति	आवृत्ति
avuti	अवुती	आवृत्ति
aavritiyon	आवृतियों	आवृत्तियों
aavrittiyon	आवृत्तियों	आवृत्तियों
avrutiyon	अवृतियों	आवृत्तियों
aashanka	आशंका	आशंका
ashanka	अशंका	आशंका
aashriton	आश्रितों	आश्रितों
ashriton	अश्रितों	आश्रितों
aasaan	आसान	आसान
aasan	आसन	आसान
asan	असन	आसान
aastik	आस्तिक	आस्तिक
astik	अस्तिक	आस्तिक
aasteen	आस्तीन	आस्तीन
aastin	आस्तिन	आस्तीन
astin	अस्तिन	आस्तीन
aahnaan	आहनान	आह्नान
aahnan	आहनन	आह्नान
ahyan	अह्यान	आह्नान
england	एंगलैंड	इंग्लैंड
engineer	एंजीनीयर	इंजिनियर
introduction	इंट्रोडक्शन	इंट्रोडक्शन
insurance	इनसर्नेंस	इंश्योरेंस
ear	ईयर	इअर
eyer	एयर	इअर
eon	एयन	इआन
iaan	इआन	इआन
ekattha	एकत्ठ	इकट्ठा
ikattha	इकत्ठ	इकट्ठा
ekatthi	एकत्ठी	इकठ्ठी
ekthi	एक्थी	इकठ्ठी
ikatthi	इकत्ठी	इकठ्ठी
ekaee	एकाई	इकाई
ikai	इकाई	इकाई
ekaeyon	एकाइयों	इकाईयों
ikaiyon	इकाइयों	इकाईयों
ikarion	इकारियन	इकाईयों
economic	एकोनोमिक	इकोनोमिक
ecuador	एक्युडार	इक्वाडोर
equador	एक्वाडोर	इक्वाडोर
equities	एक्विटिज	इक्विटीज
ikvitija	इकवितीजा	इक्विटीज
ijaajat	इजाजत	इजाजत
ijajat	इजाजत	इजाजत
inhalation	इन्हालेशन	इनहेलेशन
inhaletion	इन्हेलेशन	इनहेलेशन
ibija	इबीजा	इबीजा
ibiza	इबीजा	इबीजा
imaging	इमाइिंगग	इमेजिंग
immune	इम्यून	इम्युन
elaichi	एलेची	इलाइची
ilaichi	इलाची	इलाइची
ilayachi	इलायची	इलाइची
ilayichi	इलाईची	इलाइची
elaaj	एलाज	इलाज
ilaaj	इलाज	इलाज
ilaj	इलाज	इलाज
ishaak	इशाक	इशाक
ishaaq	इशाक	इशाक
ishak	इशाक	इशाक
ishaara	इशारा	इशारा
ishaaraa	इशारा	इशारा
ishara	इशारा	इशारा
ishita	इशीता	इशिता
isht	इष्ट	इष्ट
isteefe	इस्टीफ	इस्तीफे
istife	इज्टीफ	इस्तीफे
ea	ई	ईए
ia	आईएए	ईए
eater	एटर	ईटर
iter	आईटर	ईटर
email	एमेल	ईमेल
emailon	एमेलों	ईमेलों
emelon	एमेलों	ईमेलों
evening	एवनिंग	ईवनिंग
east	एस्ट	ईष्ट
ishat	इशा	ईष्ट
isht	इष्ट	ईष्ट
isaaiyon	इसाइयों	ईसाइयों
isaiyon	इसाइयों	ईसाइयों
isayiyon	इसाययों	ईसाइयों
ikhrul	इखरूल	उखरुल
ukhrool	उखरूल	उखरुल
ukhrul	उखरूल	उखरुल
uchhalane	उच्लाने	उछालने
uchhalne	उच्लाने	उछालने
ujback	यजबेक	उज़्बेक
uzbek	उजबेक	उज़्बेक
uthane	उठाने	उठने
uthne	उठने	उठने
uthaakar	उठाकर	उठाकर
uthakar	उठाकर	उठाकर
uthaapatak	उठापतक	उठापटक
uthapatak	उठापतक	उठापटक
uthen	उठें	उठें
udaan	उदान	उड़ान
udan	उद़न	उड़ान
udaanaa	उदाना	उड़ाना
udana	उद़ना	उड़ाना
udaane	उदाने	उड़ाने
udane	उद़ने	उड़ाने
udaanen	उदानें	उड़ानें
udanen	उद़नें	उड़ानें
udaanon	उदानों	उड़ानों
udanon	उदानों	उड़ानों
utane	उतने	उतने
utaney	उतने	उतने
utne	उतने	उतने
uttara	उत्तरा	उत्तरा
uttra	उत्तरा	उत्तरा
utpan	उत्पन	उत्पन
udant	उदांत	उदंत
udghosh	उद्घोष	उदघोष
udar	उदार	उदर
uda	उड़ा	उदा
udaa	उदा	उदा
udakishuganj	उद़कीशुजन	उदाकिशुनगंज
udakishunganj	उद़किशुंगन	उदाकिशुनगंज
unatees	अनातीस	उनतीस
untees	अन्टीज	उनतीस
uniyal	अननियल	उनियाल
upadraviyon	उपद्रवियों	उपद्रवियों
updravion	उप्ड्रवियों	उपद्रवियों
updraviyon	उपद्रवियों	उपद्रवियों
upadravi	उपद्रवी	उपद्रवी
updravi	उपद्रवी	उपद्रवी
upadrawon	उपद्रवों	उपद्रवों
updravon	उपद्रवों	उपद्रवों
upneta	उपनेता	उपनेता
upabhokta	उपभोक्त	उपभोक्ता
upbhokta	उपभोक्त	उपभोक्ता
uplaksh	उपलक्ष	उपलक्ष्य
uplakshay	उपलक्षय	उपलक्ष्य
uplakshya	उपलक्ष्य	उपलक्ष्य
uplabdh	उपलब्ध	उपलब्ध
uplabdhiyon	उपलबभियों	उपलब्धियों
uplabdhi	उपलबभी	उपलब्धी
upakhyaanon	उपख्यानों	उपाख्यानों
upakhyanon	उपख्यानोंं	उपाख्यानों
ubuntu	उबूंटू	उबंटू
ubaal	उबाल	उबाल
ubal	उबल	उबाल
ubhaara	उभारा	उभारा
ubhara	उभरा	उभारा
umanath	उमानथ	उमानाथ
umesh	उमेश	उमेश
urf	यूरफ	उर्फ
urfa	उर्फा	उर्फ
urff	यूरफफ	उर्फ
urvarakon	उर्वरकों	उर्वरकों
urvarkon	उर्वर्कों	उर्वरकों
urwarakon	उर्वारकों	उर्वरकों
urvarata	उर्वरता	उर्वरता
urvarta	उर्वरता	उर्वरता
urwarta	उर्वरता	उर्वरता
ulate	उलते	उलटे
ulte	उल्टे	उलटे
ulahana	उलहना	उलाहना
ulahna	उलहना	उलाहना
ulema	उलेमा	उलेमा
ulemaon	उलेमाओं	उलेमाओं
usak	उसक	उसक
usaki	उसकी	उसकी
uski	उस्की	उसकी
usmein	उस्में	उसमें
usmen	उस्मेन	उसमें
usi	उसी	उसी
ustara	उस्तरा	उस्तरा
udharv	उधार्व	ऊर्ध्व
udhrva	उध्रव	ऊर्ध्व
urdhav	उर्धव	ऊर्ध्व
ushma	उष्मा	ऊष्मा
rishicool	रिशिकूल	ऋषिकुल
rishikul	रिशिकुल	ऋषिकुल
rushikul	रुशिकुल	ऋषिकुल
enzyme	एंजीम	एंजाइम
anton	अंटों	एंटोन
entone	एंटन	एंटोन
antoni	अंतोनी	एंटोनी
antony	अंटोनी	एंटोनी
endometrial	एंडोमेट्रियल	एंडोमेट्रियल
andreas	एंड्रेज	एंड्रियास
als	एल्स	एएलएस
asi	असी	एएसआई
eksaath	एकसाथ	एकसाथ
eksath	एक्त	एकसाथ
ekaki	एकाकी	एकाकी
xm	एसएसएम	एक्सएम
egmor	एग्मर	एगमोर
egmore	एग्मोर	एगमोर
aj	अज	एजे
agende	अजेंडे	एजेंडे
adp	एड्पी	एडीपी
adain	अदान	एडेन
aden	एडेन	एडेन
edan	एडन	एडेन
addi	अद्दी	एड्डी
eddi	एडीी	एड्डी
eddie	एड्ई	एड्डी
eddy	एड्डी	एड्डी
apj	अपज	एपीजे
ftii	फ्टीईईईईईईईई	एफटीआईआई
abbott	अब्टोट	एबट
abut	अबूत	एबट
ebt	एबट	एबट
abvp	अब्वप	एबीवीपी
abbot	अब्ट	एबोट
abbott	अब्टोट	एबोट
mta	मैटा	एमटीए
mtake	मटके	एमटेक
mtec	मैटेक	एमटेक
mtech	मैच	एमटेक
emerald	एमरल्ड	एमरल्ड
emrald	एमरल्ड	एमरल्ड
emil	एमिल	एमिल
emile	एमिल	एमिल
emily	एमिली	एमिल
amy	अम्य	एमी
emi	एमीईईईईईईईई	एमी
airway	एयरवे	एयरवे
eyarave	एयरवे	एयरवे
eyarve	एयरवे	एयरवे
error	एररर	एरर
arica	आरिका	एरिका
erica	एरिका	एरिका
erika	एरिका	एरिका
aerobic	एयरबिकक	एरोबिक
aerobics	एयरबिक्स	एरोबिक
lte	लेट	एलटीई
lti	लीटीई	एलटीई
allergic	अले््जिक	एलर्जिक
eliminator	एलिमिनेटर	एलिमिनेटर
aliens	अलिइंस	एलियंस
alliance	एलाइन्स	एलियंस
asian	असियां	एशियन
sfc	एसएससी	एसएफसी
sk	एससीके	एसके
spf	एसएपीएफ	एसपीएफ
association	एसोसियेशन	एसोसिएशन
astar	अस्तर	एस्टर
aster	अस्तर	एस्टर
ester	एस्टर	एस्टर
aesthetics	एस्थेटिक्स	एस्थेटिक
asthetic	अस्थेतिक	एस्थेटिक
asfalt	असफाल्ट	एस्फाल्ट
asphalt	अस्फल्त	एस्फाल्ट
asphault	अस्पौल्ट	एस्फाल्ट
ahsaas	अहसास	एहसास
ehsaas	एशास	एहसास
ehsas	एशसस	एहसास
aisa	एसा	एेसा
eesa	ईसा	एेसा
ainth	ऐंठ	ऐंठ
end	एंड	ऐंठ
enth	एंथ	ऐंठ
ainthey	एंथे	ऐंठे
enthe	एंठे	ऐंठे
aithan	एथान	ऐठन
ethan	एथन	ऐठन
ethhan	एथान	ऐठन
ail	एल	ऐल
el	ईल	ऐल
alaps	अला्सस	ऐल्प्स
alps	एल्प्स	ऐल्प्स
aise	एसे	ऐसे
oxide	ऑक्साइड	ऑक्साइड
oxy	ऑक्सीी	ऑक्सी
offers	ऑफर्स	ऑफर्स
offshor	ऑफ्शोर	ऑफशोर
offshore	ऑफ्शोर	ऑफशोर
official	ऑफिसियल	ऑफिशियल
okalahoma	ओकलहोमा	ओकलाहोमा
oklahoma	ओकलाहोमा	ओकलाहोमा
oklahoma	ओकलाहोमा	ओक्लाहोमा
ot	ओट	ओत
opel	ऑपेल	ओपेल
obrayan	ओब्रायन	ओब्रायन
obrien	ऑबरीन	ओब्रायन
oran	ओरन	ओरण
orian	ऑरियन	ओरियन
orion	ऑरियन	ओरियन
olavrishti	ओलवरृष्टि	ओलावृष्टि
ovum	ओवम	ओवम
owem	ऑवम	ओवम
oceanic	ऑक्सेनिक	ओशनिक
osaka	ओसका	ओसाका
auchity	ऑचित्य	औचित्य
auchitya	औछित्य	औचित्य
audhyogikaran	औद्योगिकरण	औद्योगिकरण
audyogikarana	औद्योगिकाण	औद्योगिकरण
audyogikikaran	औद्योगिकाण	औद्योगिकरण
aurangabad	औरंगबाड़	औरंगाबाद
aurora	औरोरा	औरोरा
aulakh	औलख	औलख
kankad	कनकड़	कंकड़
kankar	कनंकर	कंकड़
kankad	कनकड़	कंकर
kankar	कनंकर	कंकर
kangan	कांगन	कंगन
conjunction	कंजन्क्शननन	कंजंक्शन
contemporary	कंटेंपररी	कंटेम्पररी
kanthahar	कंठहर	कंठहार
kanthhar	कंठहर	कंठहार
composer	कंपोसर	कंपोजर
kambalon	कांबलों	कंबलों
kanblon	कांबलों	कंबलों
consultant	कंसल्टेंट	कंसलटेंट
kakkad	कक्कड़	कक्कड़
kakkar	कक्कर	कक्कड़
kacche	कच्चे	कच्चे
kachche	कच्चे	कच्चे
karta	कररता	कटरा
katra	कतरा	कटरा
cutlery	कैट्लीी	कटलरी
katlari	कतलारी	कटलरी
katlary	कटलारी	कटलरी
katasaraj	कतासराज	कटासराज
kathfodave	कथफौड़वे	कठफोड़वे
kathfodve	कथफौड़व	कठफोड़वे
kathor	कथोर	कठोर
kathore	कथोर	कठोर
kanika	कनीका	कणिका
kathai	कथाई	कत्थई
katthai	कट्ठाई	कत्थई
katthaii	कट्ठाई	कत्थई
convention	कन्वेंशन	कनवेंशन
canals	कैनल्स	कनाल
kanaal	कनाल	कनाल
kanal	कनाल	कनाल
kanindham	कनींधम	कनिंघम
kaningham	कनींघम	कनिंघम
kanishthika	कनिष्ठिका	कनिष्ठिका
kanishthikaa	कनिष्ठिका	कनिष्ठिका
kanishtika	कनिष्टिका	कनिष्ठिका
kanyaayen	कन्याएं	कन्याएं
kanyaein	कन्याएं	कन्याएं
kanyayen	कन्याएं	कन्याएं
convention	कन्वेंशन	कन्वेंशन
convocation	कन्वोकेशन	कन्वोकेशन
cup	कुप	कप
kap	कप	कप
kapda	कपड़ा	कपड़ा
kpada	कपाड़ा	कपड़ा
kapdo	कपड़ो	कपड़ो
kapdon	कपड़ों	कपड़ो
kaping	कपिंग	कपिंग
kping	कपिंग	कपिंग
kapolkalpana	कपोलकल्पन	कपोलकल्पना
kabaddi	कबड़ी	कबड्डी
kabr	कबर	कब्र
kabra	कबरा	कब्र
kabren	कबरें	कब्रें
kabron	कबरों	कब्रों
kamjor	कामजर	कमज़ोर
kamzor	कामजर	कमज़ोर
kamatar	कमातर	कमतर
kamtar	कमतर	कमतर
kalamjeet	कलमजीत	कमलजीत
kamaljeet	कमलजीत	कमलजीत
kamaauu	कमाऊ	कमाऊ
kamau	कमौऊ	कमाऊ
kamaate	कमाते	कमाते
kamate	कमाते	कमाते
kamere	कमेरे	कमेरे
kmere	केमे	कमेरे
karanj	करणज	करंज
kranj	क्रांज	करंज
karanjiya	करणजीय	करंजिया
kardhe	करर्ेे	करघे
karghe	कर्घे	करघे
karachana	कराचना	करछना
karchhana	कर्चाना	करछना
karna	करणा	करना
karpatri	करपत्री	करपात्री
karam	कराम	करम
karoor	करूर	करूर
karur	करूर	करूर
karnataka	करणातका	कर्नाटका
karvi	करवी	कर्वी
kurvi	कुर्वी	कर्वी
kalmein	कालमें	कलमें
kalmen	कालमें	कलमें
kalraj	कलराज	कलराज
kalika	कललिका	कलिका
kalpanaon	कल्पनाओं	कल्पनाओं
kalpnaon	कल्पनाओं	कल्पनाओं
kavvaliyon	कववालियों	कव्वालियों
qawwaliyon	कववालियों	कव्वालियों
kavvali	कववाली	कव्वाली
qawwali	कववाली	कव्वाली
kashton	काष्टों	कष्टों
kasarat	कसरत	कसरत
kasrat	कसरत	कसरत
kasara	कसरा	कसारा
kasida	कसीदा	कसीदा
kahane	कहने	कहने
kahne	कहने	कहने
kahlaya	कहलाया	कहलाया
kahaniyon	कहानियों	कहानियों
kile	किले	क़िले
kanji	कांजी	कांजी
cant	कैंट	कांट
kant	कांट	कांट
kanti	कांती	कांति
kakoo	कककू	काकू
kaku	कककू	काकू
kaagaj	कागज	कागज़
kaagaz	काग़	कागज़
kagaj	काग	कागज़
kagaz	काग़	कागज़
kaaji	काजी	काजी
kaji	काजी	काजी
kazi	काजी	काजी
qazi	काजी	काजी
kajoo	काजू	काजू
kaju	काजू	काजू
kapadi	कपड़ी	कापड़ी
kapdi	कपड़ी	कापड़ी
kamraj	कमराज	कामराज
kamottejana	कमोत्तेजना	कामोत्तेजना
kamottejna	कमोट्टेजना	कामोत्तेजना
kailana	कैलना	कायलाना
kaylana	कायलना	कायलाना
carfi	कार्फी	कार्की
karki	कररी	कार्की
kartik	कार्तिक	कार्तिक
karyakartaon	कार्यकार्ताओं	कार्यकर्ताओं
karykartaaon	कार्यकारताओं	कार्यकर्ताओं
karykartaon	कार्यकार्ताओं	कार्यकर्ताओं
karyabhar	कार्यभर	कार्यभार
karybhar	कार्यभर	कार्यभार
karyarat	कार्यारत	कार्यरत
karyrat	कार्यत	कार्यरत
kaalpi	कालपी	कालपी
kalapi	काापी	कालपी
kalpi	कालपी	कालपी
kalika	कललिका	कालिका
kalighat	कलीघट	कालीघाट
coldvel	कोल्डवल	काल्डवेल
kaldvel	कल््वेल	काल्डवेल
kaldwell	काल्वेल	काल्डवेल
kaav	काव	काव
kav	कव	काव
kaasht	काष्ट	काश्त
kasht	काष्ट	काश्त
kasim	कासिम	कासिम
qasim	कासिम	कासिम
kasimabad	कसीमाबाद	कासिमाबाद
kiya	किया	किया
kiliyan	किलियां	किलियन
killat	किल्ट	किल्लत
killi	किली	किल्ली
kisaani	किसानी	किसानी
kisani	किसनी	किसानी
kisanon	किसनों	किसानों
keede	कीड़े	कीड़े
kide	कीड	कीड़े
keynote	केनोट	कीनोट
kinote	किनोट	कीनोट
kiratpur	कीरतपुर	कीरतपुर
kundal	कुंडल	कुंडल
kundaliya	कुंडलिया	कुंडलियाँ
kundaliyan	कुंडलियां	कुंडलियाँ
kutta	कुट्टा	कुत्ता
kuposhit	कुपोषित	कुपोषित
kumau	कुमौऊ	कुमाऊ
kumavat	कुमावत	कुमावत
kumawat	कुमावत	कुमावत
kural	कुरल	कुराल
kurmi	कुर्मी	कुर्मी
kursiyon	कुरसियों	कुर्सियों
kush	कुश	कुश
kushaan	कुशान	कुषाण
kushan	कुशन	कुषाण
kusumalataa	कुसुमलता	कुसुमलता
kusumalta	कुसुमलता	कुसुमलता
kusumlata	कुसुमलता	कुसुमलता
koot	कूट	कूट
kut	कुट	कूट
kritika	कृतिका	कृतिका
kpo	कपो	केपीओ
canterbari	कंंटरबारी	कैंटरबरी
canterbury	कैंटरबरी	कैंटरबरी
candidate	कैंडीडेट	कैंडिडेट
katrina	कटरिना	कैटरीना
caitlyn	कैटलीन	कैटलिन
cateline	कैटेलिइन	कैटलिन
catlin	कैटलिन	कैटलिन
cadmium	कैडमियममम	कैडमियम
catholic	कैथोलिक	कैथोलिक
catholicon	कैथोलिकनन	कैथोलिकों
kaetholikon	कैथोलिकों	कैथोलिकों
capacitor	कैपैक्टर	कैपेसिटर
carat	कारत	कैरेट
cavity	कैविटी	कैविटी
cavalry	कैवल्री	कैवेलरी
kaivelari	कैवेलरी	कैवेलरी
complex	कंप्लेक्स	कॉम्प्लेक्स
kocchi	कोच्ची	कोच्चि
kochi	कोची	कोच्चि
corridor	कॉरिडोर	कोरिडोर
corolla	कोरोला	कोरोला
korola	कोरोला	कोरोला
caolan	काओलन	कोलन
colan	कोलन	कोलन
colon	कोलों	कोलन
calling	कैलिंग	कोलिंग
koling	कोलिंग	कोलिंग
colorado	कोलोड़ो	कोलोराडो
kolorado	कोलोराडो	कोलोराडो
kaushal	कौशाल	कौशल
kaushalata	कौशालता	कौशलता
kaushalta	कौशलता	कौशलता
kaushambi	कौशंबी	कौशाम्बी
cute	कैट	क्यूट
quete	क्वेट	क्यूट
cube	कबब	क्यूब
cubeck	कबेक	क्यूबेक
quebec	क्वेबस	क्यूबेक
cubes	कबब्स	क्यूब्स
krantiyon	क्रांतियों	क्रांतियों
cric	क्रिक	क्रिक
crick	क्रिकक	क्रिक
cricket	क्रिकेट	क्रिकेट
cricketer	क्रिकेटर	क्रिकेटर
cricketing	क्रिक्टिंगगग	क्रिकेटिंग
kriyayog	क्रियायोग	क्रियायोग
christian	क्रिस्टियन	क्रिश्चयन
kruger	क्रगर	क्रूगर
craig	क्रेज	क्रेग
creg	क्रेग	क्रेग
cradle	क्रेडल	क्रैडल
chrom	च्रोम	क्रोम
chrome	च्रोम	क्रोम
client	क्लाइंट	क्लांइट
clock	क्लॉक	क्लाक
clasen	क्लेसन	क्लासें
classen	क्लासन	क्लासें
classon	क्लासों	क्लासों
clay	क्ले	क्ले
claris	क्लारिस	क्लेरिस
cleris	क्लीरिस	क्लेरिस
clerys	क्लीरिज्स	क्लेरिस
quantico	क्वांटिको	क्वांटिको
queens	क्वींस	क्वींस
kshitij	क्षितीज	क्षितिज
shitij	शीतिज	क्षितिज
kshin	क्षिण	क्षीण
shin	शीन	क्षीण
kshetron	क्षेत्रों	क्षेत्रों
shetron	शेत्रों	क्षेत्रों
khand	खंंड	खंडा
khanda	खंडा	खंडा
khachakhach	खचखाच	खचाखच
khajarana	खजरना	खजराना
khajraana	खजराना	खजराना
khajrana	खजराना	खजराना
khatakati	खतकती	खटकती
khatakti	खतकती	खटकती
kihatkati	किहत्कती	खटकती
khattapan	खत्तपन	खट्टापन
khat	खत	खत
khani	खानी	खनि
khanik	खानिक	खनिक
khanikarm	खनीकर्म	खनिकर्म
khanikarma	खननीकर्म	खनिकर्म
khanikarmi	खनीकार्मी	खनिकर्म
khapat	खपत	खपत
khariya	खरीया	खरिया
khalnayak	खलनायक	खलनायक
khaaskar	खासकर	ख़ासकर
khaskar	खस्कर	ख़ासकर
khaastaur	खास्तौर	ख़ासतौर
khastaur	खस्तौर	ख़ासतौर
khaibar	खैबर	ख़ैबर
khyber	ख्यबर	ख़ैबर
khaein	खाएं	खाएं
khaen	खाएं	खाएं
khayen	खाएं	खाएं
khaate	खाते	खाते
khaatey	खाते	खाते
khate	खते	खाते
khal	खाल	खाल
khinchakar	खिंचकर	खिंचकर
khinchkar	खिंचकर	खिंचकर
khilana	खिलना	खिलाना
khinchkar	खिंचकर	खींचकर
khuda	खुड़ा	खुदा
khudai	खुदाई	खुदाई
khurapka	खुरापका	खुरपका
khurpaka	खुरपका	खुरपका
khurasan	खुरसन	खुरासान
khushiyan	खुशियां	खुशियां
khene	खेने	खेने
khaini	खैनी	खैनी
khairati	खैरती	खैराती
khoikhoi	खोईखोई	खोईखोई
khoya	खोया	खोया
gangrel	गंग्रेल	गंगरेल
gangaajal	गंगाजल	गंगाजल
gangajal	गंगाल	गंगाजल
gandaki	गंडकी	गंडकी
gandki	गंडकी	गंडकी
gandh	गंंध	गंध
gandha	गंधा	गंध
gae	गाए	गए
gaye	गाय	गए
gajara	गजरा	गजरा
gajra	गजरा	गजरा
gadkar	गड़कर	गडकर
ganapati	गणपती	गणपति
ganpati	गणपती	गणपति
gatisheel	गतिशील	गतिशील
gatishil	गतिशील	गतिशील
gatishilata	गतिशिलता	गतिशीलता
gadadhar	गदाधार	गदाधर
gammat	गम्मत	गम्मत
gaya	गाया	गया
garibi	गरिबी	गरीबी
garjana	गर्जना	गर्जना
galgand	गलगंड	गलगंड
gahmagahmi	गहमगाहमी	गहमागहमी
gemhagehmi	जेहाेहमी	गहमागहमी
ganguly	गंगुल्य	गांगुली
gaanth	गांथ	गांठ
ganth	गंथ	गांठ
gaanthe	गांठे	गांठे
ganthe	गंथे	गांठे
ganthen	गंथें	गांठें
ganthon	गंथों	गांठों
gaen	गाएं	गाएं
gayen	गाएं	गाएं
gazi	गाजी	गाज़ी
gajipur	गजीपुर	गाजीपुर
gazipur	गजीपुर	गाजीपुर
gayatri	गायत्री	गायत्री
gayitri	गायत्री	गायत्री
gaytri	गायत्री	गायत्री
gidgidate	गिजगीडेट	गिड़गिड़ाते
ginate	गिनते	गिनते
ginte	गिंटे	गिनते
girkar	गिरकार	गिरकर
girijaghar	गिरिजाघर	गिरजाघर
girjaghar	गिरजाघर	गिरजाघर
girijagharon	गिरिजाघरों	गिरजाघरों
girjagharon	गिरजाघरों	गिरजाघरों
girati	गिरती	गिरती
girti	गिरती	गिरती
girish	गिरिश	गिरीश
guan	ग्वान	गुआन
gujar	गुजार	गुजार
gujarata	गुजरता	गुजारता
gujarta	गुजरता	गुजारता
gujarate	गुजारते	गुजारते
gujarte	गुजरते	गुजारते
gujarana	गुजरना	गुजारना
gujarna	गुजरना	गुजारना
gujara	गुजारा	गुजारा
gujare	गुजारे	गुजारे
gutta	गुत्ता	गुट्टा
gthalidar	ग्थलीदार	गुठलीदार
guthalidar	गुथलीदार	गुठलीदार
gudna	गुड़ना	गुदना
gumaan	गुमान	गुमान
guman	गुमान	गुमान
gulshan	गुल्षण	गुलशन
gunga	गुंगा	गूंगा
grihnagar	गृहनगर	गृहनगर
gruhnagar	गृहनागर	गृहनगर
galaxion	गैल्शन	गैलेक्सियों
galaxiyon	गलल्सियों	गैलेक्सियों
galaxyon	गलल्स्यों	गैलेक्सियों
gochar	गोचार	गोचर
gouchar	गुचार	गोचर
godara	गोडारा	गोदारा
gopichand	गोपिचंड	गोपीचंद
gomake	गोमके	गोमके
gomke	गोमक	गोमके
goel	गोल	गोयल
goyal	गोयल	गोयल
gosvaami	गोस्वामी	गोस्वामी
gosvami	गोस्वामी	गोस्वामी
goswami	गोस्वामी	गोस्वामी
gaumukh	गौमुख	गौमुख
gomukh	गोमुख	गौमुख
gaumutr	गौमुत्र	गौमूत्र
gaumutra	गौमुत्र	गौमूत्र
gowmutra	गोममुत्र	गौमूत्र
granthiyaan	ग्रांथियां	ग्रंथियां
granthiyan	ग्रांथियां	ग्रंथियां
grandhiyon	ग्रांधियों	ग्रंथियों
granthiyon	ग्रांथियों	ग्रंथियों
greest	ग्रीस्ट	ग्रीस्ट
greist	ग्रेस्ट	ग्रीस्ट
grist	ग्रिस्ट	ग्रीस्ट
greg	ग्रेग	ग्रेग
granite	ग्रेनिट	ग्रेनाइट
grenite	ग्रेनिट	ग्रेनाइट
grandson	ग्रांडसोंन	ग्रैंडसन
gross	ग्रॉस	ग्रॉस
ghataatop	घटातोपप	घटाटोप
ghatatop	घटटोप	घटाटोप
ghataayaa	घटाया	घटाया
ghataya	घटाया	घटाया
ghanakar	घनकर	घनाकार
ghabrahat	घबराहट	घबराहट
ghasi	घासी	घासी
ghisai	घिसाई	घिसाई
ghisi	घिसी	घिसी
ghise	घिसे	घिसे
ghumakkadi	घुमक्का़ी	घुमक्कड़ी
ghumakkdi	घुमक्कड़ी	घुमक्कड़ी
ghumakkadon	घुमक्कड़ों	घुमक्कड़ों
ghumakkaron	घुमक्कारों	घुमक्कड़ों
ghumakkdon	घुमक्कड़ों	घुमक्कड़ों
ghummakkadon	घुम्मककाडों	घुमक्कड़ों
ghumaan	घुमान	घुमाण
ghuman	घुमान	घुमाण
ghoonsa	घूंसा	घूंसा
ghunsa	घुंसा	घूंसा
ghongha	घोंघा	घोंघा
ghontane	घोंटने	घोंटने
ghontne	घोंटने	घोंटने
ghot	घोट	घोट
ghodi	घोड़ी	घोड़ी
ghost	घोस्ट	घोस्ट
changul	चंगुल	चंगुल
chand	चांद	चंद
chandan	चंंदन	चंदन
chandana	चंडना	चंदन
chandu	चंंडु	चंदू
chandon	चंंडों	चंदों
chandrabali	चंद्रबाली	चंद्रबली
chandramaon	चंद्रमाओं	चंद्रमाओं
chakatte	चकत्ते	चकत्ते
chaktte	चक्तते	चकत्ते
chakkar	चक्कर	चक्कर
chkkar	चक्कर	चक्कर
chakshu	चक्षु	चक्षु
chatagaon	चतागाओं	चटगांव
chatgaon	चतगाओं	चटगांव
chadhane	चढ़ने	चढ़ने
chadhne	चढ़ने	चढ़ने
chaturdik	चतुर्दिक	चतुर्दिक
chatunshkoniy	चतुंशकों	चतुष्कोणीय
chatushkoniy	चतुश्कों	चतुष्कोणीय
chatushkoniya	चतुश्कोणीय	चतुष्कोणीय
channa	चन्ना	चन्ना
chabate	चबाते	चबाते
chabutare	चबुतारे	चबूतरे
chabutre	चबुत्रे	चबूतरे
chamakna	चमकना	चमकना
chamkana	चमकना	चमकना
charas	चारस	चरस
charit	चारित	चरित
charcha	चर्चा	चर्चा
churcha	चुर्चा	चर्चा
charchaon	चर्चाओं	चर्चाओं
chalenge	चालेंगे	चलेंगे
chlenge	च्लेंगे	चलेंगे
chahunaur	चहुनौर	चहुंओर
chahunor	चहहूनर	चहुंओर
chanval	चनवाल	चांवल
chanwal	चनवाल	चांवल
chachaji	चचाजी	चाचाजी
chadar	चदार	चादर
chadaron	चदारों	चादरों
chadron	चाद्रों	चादरों
chan	चान	चान
chanan	चननन	चानन
chaplusi	चपलुसी	चापलूसी
chayal	चयाल	चायल
char	चार	चार
charon	चारों	चारों
charge	चार्ज	चार्ज
chart	चार्ट	चार्ट
charton	चार्तों	चार्टों
charts	चार्ट्सस	चार्ट्स
chaalit	चालित	चालित
chalit	चलित	चालित
chikitsak	चिकित्सक	चिकित्सक
chikitsakon	चिकित्सकों	चिकित्सकों
chikhali	चिखली	चिखली
chiththi	चिठ्ठी	चिट्ठी
chitthi	चित्थी	चिट्ठी
chithhi	चिठी	चिठ्ठी
chiththi	चिठ्ठी	चिठ्ठी
chitthi	चित्थी	चिठ्ठी
chidchidapan	चिड़चिड़पन	चिडचिडापन
chidchidapan	चिड़चिड़पन	चिड़चिड़ापन
chidhate	चिढ़ते	चिढ़ते
chidhte	चिढ़ते	चिढ़ते
chithrkar	चित्रकर	चित्रकार
chitrkar	चित्रकार	चित्रकार
chipakane	चिपकने	चिपकने
chipakne	चिपकने	चिपकने
chipkane	चिपकने	चिपकने
chimati	चिमती	चिमटी
chimti	चिमती	चिमटी
chillane	चिल्लेन	चिल्लाने
chee	ची	ची
chi	चीई	ची
chuka	चुका	चुका
chune	चुने	चुने
chunar	चुनर	चूनर
changed	चैंगेड	चेंज्ड
chetti	चेत्ती	चेट्टी
chennai	चेननाई	चेन्नई
chero	चेरो	चेरो
chest	चेस्ट	चेस्ट
championship	चंपिशंशप	चैंपियनशिप
chor	चोर	चोर
choro	चोरो	चोरों
choron	चोरों	चोरों
chauk	चौक	चौक
chowk	चौक	चौक
chauka	चौका	चौका
chuka	चुका	चौका
chaukiyan	चौकियां	चौकियां
chauki	चौकी	चौकी
chaukhate	चौखते	चौखटे
chauguni	चौगुनी	चौगुनी
chauda	चौड़ा	चौड़ा
chaudah	चौदह	चौड़ा
chaudahavan	चौदहवां	चौदहवां
chaudhavan	चौधवान	चौदहवां
chaudhawan	चौधवान	चौदहवां
chaupati	चौपती	चौपाटी
chupaty	चुपत्य	चौपाटी
chaupal	चौपल	चौपाल
chaurai	चौराई	चौरई
chausinga	चौसिंगा	चौसिंगा
chausingha	चौसिंहा	चौसिंगा
chhagan	छगन	छगन
chhabi	छाबी	छबि
chhalla	छल्ला	छल्ला
chhallaa	छल्ला	छल्ला
chhaviyaan	छवियां	छवियाँ
chhaviyan	छवियां	छवियाँ
chhavi	छावी	छवी
cheh	चेह	छह
chhah	छाह	छह
chehon	चेहों	छहों
chhahon	छहहों	छहों
chhai	छाई	छाई
chhagla	छगला	छागला
chhajan	छजन	छाजन
chhaati	छाती	छाती
chhati	छती	छाती
chhaapemaar	छापेमार	छापेमार
chhapemar	छपेमार	छापेमार
chheenk	छींक	छींक
chhink	छींक	छींक
chink	चींक	छींक
chenkein	चेंकें	छींके
chhekein	छेकें	छींके
chhinke	छींके	छींके
chhinky	छींकी	छींके
chinke	चींके	छींके
chhudaane	छुड़ाने	छुडाने
chhudane	छुड़ने	छुडाने
chhupakar	छुपकर	छुपकर
chhupkar	छुपकर	छुपकर
chhupkr	छुपक्र	छुपकर
chhupata	छुपता	छुपता
chhupta	छुप्त	छुपता
chhuptaa	छुप्ता	छुपता
chhura	छुरा	छुरा
chhuraa	छुरा	छुरा
chhuree	छुरे	छुरी
chhuri	छुरी	छुरी
chhure	छुरे	छुरे
chhootane	छूटने	छूटने
chhutane	छुट्टेन	छूटने
chhutne	छुट्ने	छूटने
chheter	छेतर	छेत्र
chhetr	छेत्र	छेत्र
chhetter	छेतर	छेत्र
chhetri	छेत्री	छेत्री
chhetthari	छेत्थरी	छेत्री
chhetthri	छेत्थरी	छेत्री
chai	चाई	छै
chhai	छाई	छै
chhe	छे	छै
jagaega	जगाएगा	जगाएगा
jagayega	जगाएगा	जगाएगा
jaghaega	जााएगा	जगाएगा
jgaayega	जगाएगा	जगाएगा
jgayegaa	जगाएगा	जगाएगा
jajaon	जजाओं	जजों
jajon	जजों	जजों
jad	जाद	जड़
jadd	जाद	जड़
jaddit	जादीत	जड़ित
jadeite	जाडेट	जड़ित
jadet	जादेत	जड़ित
jadit	जादित	जड़ित
jadein	जादें	जड़ें
jaden	जादें	जड़ें
jatara	जतरा	जतरा
jatra	जात्रा	जतरा
jataati	जताती	जताती
jatatee	जतती	जताती
jatati	जततती	जताती
janagananaa	जनगनना	जनगणना
janaganna	जनगननना	जनगणना
jangadnaa	जंगड़ना	जनगणना
janganana	जंगनना	जनगणना
janganna	जंगननना	जनगणना
janajagran	जनजाग्रण	जनजागरण
janjaagran	जनजाग्रण	जनजागरण
janjagran	जनजाग्रण	जनजागरण
january	जननुयरी	जनवरी
janahaani	जनहानी	जनहानि
janahani	जनहनी	जनहानि
janhaani	जनहानी	जनहानि
janhani	जनहननी	जनहानि
jnhaani	जनहानी	जनहानि
jamaate	जमाते	जमाती
jamaati	जमाती	जमाती
jamati	जमती	जमाती
jamaaya	जमाया	जमाया
jamaeya	जमाए	जमाया
jamaya	जमाया	जमाया
jamayaa	जमाया	जमाया
jamuai	जमुए	जमुई
jamuei	जमुए	जमुई
jamui	जमुई	जमुई
jai	जाई	जय
jay	जय	जय
jaidayal	जयदयाल	जयदयाल
jayadayal	जयादयल	जयदयाल
jaydayal	जययदायल	जयदयाल
jaibaan	जयबान	जयबाण
jaiban	जैबन	जयबाण
jaybaan	जयबान	जयबाण
jayalalita	जयलालिता	जयललिता
jayalalitaa	जयलालिता	जयललिता
jayalalithaa	जयलालिठा	जयललिता
jaylalita	जयलालिता	जयललिता
jarakh	जरख	जरख
zarakh	जररख	जरख
jarda	जर्दा	जर्दा
jardaa	जरदा	जर्दा
zarda	जर्दा	जर्दा
jalagati	जलाती	जलगति
jalgati	जलगती	जलगति
jalgti	जलगती	जलगति
jalte	जलते	जलते
jalbharav	जलभाव	जलभराव
jalbhraav	जलभराव	जलभराव
jalbhrav	जलभरव	जलभराव
jalvaayu	जलवायु	जलवायु
jalvayu	जलवायु	जलवायु
jalesar	जलेसर	जलेसर
jasmeet	जसमीत	जसमीत
jasmit	जसमीत	जसमीत
jassee	जसी	जस्सी
jassi	जससी	जस्सी
jamaanaa	जमाना	ज़माना
jamana	जमाना	ज़माना
zamaanaa	जमाना	ज़माना
zamana	ज़ााना	ज़माना
jaljale	जलजले	ज़लज़ले
zalzale	जललाले	ज़लज़ले
zee	जी	ज़ी
jubaan	जुबान	ज़ुबान
juban	जुबन	ज़ुबान
zuban	जुबन	ज़ुबान
jaanch	जांच	जाँच
jaaunch	जांच	जाँच
janch	जांच	जाँच
jaunch	जांच	जाँच
jaagriti	जाग्रिति	जागृति
jagriti	जगरीति	जागृति
jagruti	जगरूती	जागृति
jajamau	जजमाऊ	जाजमऊ
jajmau	जजमौ	जाजमऊ
jajmauu	जजमौऊ	जाजमऊ
jaat	जात	जात
jat	जात	जात
jaatak	जातक	जातक
jatak	जातक	जातक
jaatakon	जातकों	जातकों
jaatkon	जातकों	जातकों
jatakon	जतकों	जातकों
jaatiyon	जातियोंंं	जातियों
jatiyon	जतियोंंं	जातियों
jaankaaron	जानकारों	जानकारों
jaankaron	जानकारों	जानकारों
jankaron	जनकारों	जानकारों
jaanam	जानम	जानम
janam	जन्म	जानम
jaayke	जायके	जायके
jayke	जयके	जायके
jaawar	जावर	जावर
zawar	जवार	जावर
jing	जिंग	जिंग
gin	गीन	जिन
jeen	जीन	जिन
jin	जीन	जिन
ginee	गिनी	जिनी
jinee	जिनी	जिनी
jini	जिनी	जिनी
geneva	गेनेवा	जिनीवा
jeneva	जेनेवा	जिनीवा
jiniva	जिनीवा	जिनीवा
gypsy	ज्इप्सी	जिप्सी
jimme	जीम्मे	जिम्मे
jiya	जीया	जिया
gic	गीकी	जीआईसी
gr	गीआर	जीआर
gm	जीएम	जीएम
gsm	गीएमएम	जीएसएम
gtod	ग्टोड	जीतोड़
gtor	ग्टर	जीतोड़
jeetod	जीतोड़	जीतोड़
jitod	जितोड़	जीतोड़
jean	जेन	जीन
jeen	जीन	जीन
jin	जीन	जीन
jeenon	जीनों	जीनों
jinon	जिनों	जीनों
jeepney	जीपने	जीपनी
jipani	जीपनी	जीपनी
jeeyo	जीयो	जीयो
jio	जियो	जीयो
jiyo	जियो	जीयो
jeera	जीरा	जीरा
jira	जीरा	जीरा
jeevant	जीवंत	जीवंत
jivant	जीवंत	जीवंत
jeevan	जीवन	जीवन
jeewan	जीवन	जीवन
jivan	जीवन	जीवन
jiwan	जीवन	जीवन
jeevanshaili	जीवनशीली	जीवनशैली
jivanshaili	जीवनशाली	जीवनशैली
jeevniyaan	जीवनीयां	जीवनियां
jivaniya	जीवनीय	जीवनियां
jivaniyaan	जीवनियां	जीवनियां
jivaniyan	जीवनियां	जीवनियां
jeevraaj	जीवराज	जीवराज
jivraj	जीवराज	जीवराज
jua	जुआ	जुए
jue	जू	जुए
juye	जूए	जुए
jutee	जुती	जुटी
juti	जुटी	जुटी
judaai	जुड़ाई	जुड़ाई
judae	जुड़ाए	जुड़ाई
judai	जुड़ाई	जुड़ाई
judaai	जुड़ाई	जुदाई
judai	जुड़ाई	जुदाई
junoon	जूनून	जुनून
junun	जुनून	जुनून
junooni	जूनूनी	जुनूनी
jununi	जुनुनी	जुनूनी
jubair	जुबैर	जुबेर
juber	जबब	जुबेर
zubair	जुबाई	जुबेर
juraab	जुराब	जुराब
jurab	जुराब	जुराब
julaahon	जुलाहों	जुलाहों
julahon	जुलाहों	जुलाहों
julmon	जूल्मों	जुल्मों
zulmon	जुल्मों	जुल्मों
jood	जूड़	जूड
jud	जुड़	जूड
junagadh	जुनागढ़	जूनागढ
junagarh	जुनागढ़	जूनागढ
junior	जुनियर	जूनियर
jealous	जेलस	जूलूस
juloos	जूलूस	जूलूस
julus	जुलूस	जूलूस
jetha	जेठा	जेठा
jenner	जेनर	जेनर
generic	जेनरिक	जेनरिक
jenrick	जेनरिकक	जेनरिक
generat	जेनेट	जेनरेट
generate	जेनेट	जेनरेट
jenee	जेनी	जेनी
jenni	जेननी	जेनी
jenny	जेननी	जेनी
james	जमेस	जेम्स
jeremy	जेरीमी	जेरेमी
gerome	जररोम	जेरोम
jerome	जररोम	जेरोम
jacks	जैक्स	जैक्स
jain	जाइन	जैन
gene	गेन	जैने
jaine	जैने	जैने
jaino	जैनो	जैनों
jainon	जैनों	जैनों
jerry	जेरी	जैरी
jasper	जैसपर	जैस्पर
jogging	जोगिंगगग	जॉगिंग
johnson	जॉन्सन	जॉनसन
jobs	जोब्स	जॉब्स
jockey	जॉकी	जोकि
joki	जोकी	जोकि
jokhim	जोखीम	जोखिम
joddta	जोड़ता	जोड़ता
jodta	जोड़ता	जोड़ता
jorhta	जोऱता	जोड़ता
jodiyon	जोड़ियों	जोड़ियों
jodo	जोड़ो	जोड़ो
jaun	जां	जौं
gyatavya	ज्ञातव्य	ज्ञातव्य
gyatvy	ज्ञात््य	ज्ञातव्य
gyapit	ज्ञापित	ज्ञापित
jyotiba	ज्योतिबा	ज्योतिबा
joint	जॉइंट	ज्वाइंट
jvar	ज्वर	ज्वार
jwar	ज्वर	ज्वार
jvaaron	ज्वारों	ज्वारों
jvaron	ज्वरों	ज्वारों
jwaron	ज्वारों	ज्वारों
jewellers	ज्वेल्स	ज्वेलर्स
jh	झ	झ
jha	झा	झ
jhalakti	झलकती	झलकती
jhalkati	झलकती	झलकती
jhalla	झल्ला	झल्ला
jhankana	झनकना	झांकना
jhankna	झनकना	झांकना
jheel	झील	झील
jhil	झील	झील
jheelon	झीलों	झीलों
jhilon	झीलों	झीलों
jhuthala	झूठला	झुठला
jhuthla	झूठला	झुठला
jhuthalane	झूठलने	झुठलाने
jhuthlane	झूठलाने	झुठलाने
tankaar	तनकार	टंकार
tankar	तनकर	टंकार
takara	तकरा	टकरा
takra	तकरा	टकरा
takaraon	तकराओं	टकरावों
takravon	तकरावों	टकरावों
tapakti	तपक्ति	टपकती
tapkati	तपकती	टपकती
time	टीम	टाइम
timer	टीमर	टाइमर
taoo	ताऊ	टाऊ
tau	ताऊ	टाऊ
tapoowo	तापूवो	टापुओं
tapuon	तापूओं	टापुओं
tapuwo	तापूवो	टापुओं
tied	टीइड	टायर्ड
tired	टीरेड	टायर्ड
tyred	ट्यर्ड	टायर्ड
tarch	टार्च	टार्च
torch	टोर्च	टार्च
tik	टीक	टिक
teap	टेप	टिप
tip	टीप	टिप
tippanikar	तीप्पणिकार	टिप्पणीकार
tippnikar	तीप्पनिकार	टिप्पणीकार
tivolee	टीवोली	टिवोली
tivoli	तीवोली	टिवोली
teekamgarh	तीकमगढ़	टीकमगढ़
tikamgarh	तीकागढ़	टीकमगढ़
teekon	टीकों	टीकों
tikon	टीकों	टीकों
two	ट्वो	टु
tension	टेंसन	टेंशन
tenis	टेनिस	टेनिस
tennis	टेनिस	टेनिस
taste	तस्ते	टेस्ट
test	टेस्ट	टेस्ट
tasting	टैस्टिंगगग	टेस्टिंग
testing	टेस्टिंग	टेस्टिंग
tainin	तैनीन	टैनिन
tenin	टेनिन	टैनिन
tanish	तनीश	टैनिस
tennis	टेनिस	टैनिस
taboo	टबू	टैबू
taiboo	टैबू	टैबू
taobao	ताबाओ	टैबू
tonic	टोनिक	टॉनिक
tonga	टोंगा	टोंगा
toka	टोका	टोका
tuesday	तुयूस्डे	ट्यूजडे
tuning	टुनिंग	ट्यूनिंग
tuberculosis	टब्बर्कलसिजस	ट्यूबरक्यूलोसिस
tuberkyulosis	टब्बर्युलोसिसज	ट्यूबरक्यूलोसिस
truck	ट्रूक	ट्रक
trangistor	ट्रांगिस्टर	ट्रांजिस्टर
tranjister	ट्रांजीस्टर	ट्रांजिस्टर
transistor	ट्रांसिस्टर	ट्रांजिस्टर
transfer	ट्रांसफर	ट्रान्सफर
tribunal	ट्रीबनलन	ट्रिब्युनल
tribunal	ट्रीबनलन	ट्रिब्यूनल
trubyunal	ट्रब्युनल	ट्रिब्यूनल
truth	त्थु	ट्रुथ
tuth	तूथ	ट्रुथ
traded	ट्रेड	ट्रेडेड
trabal	ट्रबल	ट्रेबल
trebal	ट्रेबल	ट्रेबल
trouble	ट्राउब	ट्रेबल
traip	ट्रेप	ट्रैप
trap	ट्राप	ट्रैप
trot	ट्रोट	ट्रॉट
trott	ट्रोट	ट्रॉट
thakkar	थक्कर	ठक्कर
thakkr	थक्क	ठक्कर
thaharne	थहरने	ठहरने
thahrane	थहराने	ठहरने
theharne	थहरने	ठहरने
thikane	थीकने	ठिकाने
thumari	थूमारी	ठुमरी
thumri	थूम्ी	ठुमरी
theinga	थेंगा	ठेंगा
thenga	थेंगा	ठेंगा
thengaa	थेंगा	ठेंगा
daglas	दगलास	डगलस
douglas	डोगलास	डगलस
dabhara	दभरा	डभरा
dabhra	दभभा	डभरा
dabhoi	दभभोई	डभोई
dam	दम	डम
dum	दम	डम
darate	दरते	डराते
daratey	दरते	डराते
daravani	दरवानी	डरावनी
darawani	दरवानी	डरावनी
dravani	द्रवाणी	डरावनी
down	डॉन	डाउन
daak	दाक	डाक
dak	दक	डाक
daka	दका	डाका
dabi	दबी	डाबी
dabolim	डबोलिम	डाबोलिम
dinosaur	दिनोसौर	डायनासोर
diaries	डायरिज	डायरीज
dit	दीत	डिट
depthiriya	देप्थिरीय	डिप्थीरिया
diphtheria	दिफ्थररिया	डिप्थीरिया
de	डे	डीई
dealership	देलर्शिप	डीलरशिप
dvc	डीएीसीी	डीवीसी
dubaana	दुबाना	डुबाना
dubana	दुबना	डुबाना
dubona	दूबोना	डुबोना
dulne	दुलने	डुलने
doonarpur	दूनरपपुर	डूंगरपुर
doongarpur	दूंगरपुर	डूंगरपुर
dungarpur	दुंगरपुर	डूंगरपुर
dungerpur	दुंगरपुर	डूंगरपुर
dubana	दुबना	डूबना
dubna	दूबना	डूबना
dangerous	डैंगररोजसस	डेंजरस
daisy	दैस्य	डेजी
dazy	देजी	डेजी
deji	देजी	डेजी
deputy	डिप्टी	डेप्युटी
davidson	दविद्सन	डेविडसन
devidson	देविज्सन	डेविडसन
davey	देवे	डेवी
devi	देवी	डेवी
dewey	डेवे	डेवी
destination	डिस्टिनेशन	डेस्टिनेशन
datson	डात्सन	डैटसन
datsun	दत्सुन	डैटसन
daddy	डेडी	डैडी
dark	डार्क	डॉर्क
dork	डोर्क	डॉर्क
dose	डोसे	डोज
domenic	डोमेनिक	डोमेनिक
doranda	दोरंडा	डोरंडा
dolane	डोलने	डोलने
dolne	डोलने	डोलने
dual	दुआल	ड्युअल
duak	दुआक	ड्यूक
duke	दुके	ड्यूक
drame	ड्रेम	ड्रामे
dramen	द्रेमन	ड्रामे
drager	ड्रेजर	ड्रेजर
dredger	ड्रेजर	ड्रेजर
dreijer	ड्रेजर	ड्रेजर
dhakaal	धकाल	ढकाल
dhakal	ढकाल	ढकाल
dhakkal	धक्कल	ढकाल
dhkal	ढकल	ढकाल
dhale	ढाले	ढले
dhoondh	धूंध	ढूंढ
dhundh	धूंध	ढूंढ
dhoondhata	धूनधता	ढूंढता
dhundhata	धुंधता	ढूंढता
dhundhta	धुंधता	ढूंढता
dhoondhi	धूंधी	ढूंढी
dhundhi	धुंधी	ढूंढी
tanjavur	तंजावूर	तंजावुर
thanjavur	थंजावूर	तंजावुर
tantr	तंंत्र	तंत्र
tantra	तंत्र	तंत्र
tantrikao	तंत्रिकाओ	तंत्रिकाओं
tantrikaon	तंत्रिकाओं	तंत्रिकाओं
tantro	तंंत्रो	तंत्रों
tantron	तंत्रों	तंत्रों
tagade	तगड़े	तगड़े
tagde	टगड़े	तगड़े
tadipaar	तदीपार	तड़ीपार
tadipar	तदीपार	तड़ीपार
tani	तानी	तनी
tapan	तपन	तपन
tarafa	तरफा	तरफा
tarfa	तर्फा	तरफा
tarabganj	तरबबंज	तरबगंज
taras	तारस	तरस
taraash	तराश	तराश
tarash	ताराश	तराश
tarashay	तराशय	तराशे
tarashe	तराशे	तराशे
tareeko	टरीको	तरीको
tariko	टारिको	तरीको
tark	टार्क	तर्क
tarkvaad	तर्कवाद	तर्कवाद
tarkvad	तर्कवाद	तर्कवाद
tarkwaad	तर्कवाद	तर्कवाद
tarko	टारको	तर्कों
tarkon	टारकों	तर्कों
talabgaar	तलबगार	तलबगार
talabgar	तालबार	तलबगार
talbagaar	तलबागार	तलबगार
talbagar	तालबार	तलबगार
talawe	तालवे	तलवे
talve	तालवे	तलवे
talawon	तालवोंं	तलवों
talvon	तालवों	तलवों
tahakhana	तहखाना	तहखाना
tahkhaana	तहखाना	तहखाना
tahkhana	तहखाना	तहखाना
taantaa	तांता	तांता
tanta	तांता	तांता
tambe	टेंबे	तांबे
tanbe	टांबे	तांबे
taaja	ताजा	ताजा
taajaa	ताजा	ताजा
taaza	ताज़ा	ताजा
taja	ताजा	ताजा
taza	ताजा	ताजा
tansen	तांसें	तानसेन
taapmaanon	तापमानों	तापमानों
tapmano	तपमानों	तापमानों
tapmanon	तपमानों	तापमानों
taapti	तापती	ताप्ती
tapti	तपती	ताप्ती
tarabai	तरबाई	ताराबाई
taseer	तसीर	तासीर
tasir	तासर	तासीर
taahi	ताही	ताहि
tahi	तही	ताहि
tikone	टीकोन	तिकोने
tirupati	तीरूपति	तिरूपति
tiwari	तीवारी	तिवारी
ti	तीई	ती
teer	तीर	तीर
tir	तीर	तीर
teeron	टीरों	तीरों
tiron	टीरों	तीरों
tirthatan	तीर्थतन	तीर्थाटन
tungnath	तुंगनाथ	तुंगनाथ
tughlaq	तुघला	तुगलक
tuglak	तुगलक	तुगलक
tughlakabad	तुघलाकाब	तुगलकाबाद
tughlaqabad	तुघलाबाड़	तुगलकाबाद
tuglakabad	तुगलाकाब	तुगलकाबाद
tugalaki	तुगलकी	तुगलकी
tugalki	तुगलकी	तुगलकी
tuglaki	तुगलाकी	तुगलकी
tufail	टूफेल	तुफैल
tejaji	तेजाजी	तेजाजी
teji	तेजी	तेजी
tel	टेल	तेल
telon	टेलों	तेलों
to	टो	तो
toh	तोह	तो
taul	टाउल	तौल
tyohaar	त्योहार	त्यौहार
tyohar	त्योहार	त्यौहार
tyoihar	त्योहार	त्यौहार
tyauharon	त्यौहारों	त्यौहारों
tyoharon	त्योहारों	त्यौहारों
tyoiharon	त्योहारों	त्यौहारों
trijata	त्जीता	त्रिजटा
trijta	त्जता	त्रिजटा
triya	त्रिया	त्रिया
tremasik	त्रेमासिक	त्रैमासिक
trimasik	त्रिमासिक	त्रैमासिक
tse	ट्से	त्से
thaki	थकी	थकी
thki	थकी	थकी
tharti	थरती	थर्टी
thirty	थीर्टी	थर्टी
thane	थाने	थाणे
thaanvi	थानवी	थानवी
thanvi	थनवी	थानवी
theateron	थीटरों	थिएटरों
theatron	थीत्रों	थिएटरों
theaters	थीटर्स	थिएटर्स
theater	थीटर	थियेटर
theatre	थीत्रे	थियेटर
theateron	थीटरों	थियेटरों
theatron	थीत्रों	थियेटरों
thitron	थित्रों	थियेटरों
theaters	थीटर्स	थियेटर्स
theatrs	थीट्र्स	थियेटर्स
thiyeters	थाइटर्स	थियेटर्स
thirake	थीरके	थिरके
thirke	थीरके	थिरके
thief	थीफ	थीफ
then	थेन	थेन
theni	थेनी	थेनी
thailee	थैली	थैली
thaili	थैली	थैली
thaile	थाइले	थैले
dang	दांग	दंग
danga	दंगा	दंगा
dangon	दंगों	दंगों
dampati	दमपती	दंपति
danpati	दनपती	दंपति
dampatiyon	दमपतियों	दंपतियों
dampattiyon	दमपत्तियों	दंपतियों
danptiyon	दानपतियों	दंपतियों
dadreva	दद्रेवा	ददरेवा
dadrewa	दद्रेवा	ददरेवा
damoh	दमोह	दमोह
dardara	दरदारा	दरदरा
dardraa	दर्द्रा	दरदरा
durdhara	दुर्धारा	दरदरा
darmiyaan	दर्मियां	दरमियान
darmiyan	दर्मियां	दरमियान
darjano	दर्जनों	दर्जनों
darjanon	दर्जनों	दर्जनों
darp	दार्प	दर्प
darra	दररा	दर्रा
dalbadal	दलबाल	दलबदल
dalbadl	डालबल	दलबदल
dali	दाली	दली
dastaanaa	दस्ताना	दस्ताना
dastana	दास्ताना	दस्ताना
dastavej	दस्तवेज	दस्तावेज
dahan	दहन	दहन
dahal	दहल	दहल
da	दा	दा
daakhil	दाखिल	दाखिल
dakhil	दखील	दाखिल
daakhile	दाखिले	दाखिले
dakhile	दखखले	दाखिले
daataa	दाता	दाता
data	दता	दाता
dadari	दादरी	दादरी
daanshil	दांशील	दानशील
danshil	दंशील	दानशील
daabholkar	दाभोलकर	दाभोलकर
dabholkar	दभभोलकर	दाभोलकर
damale	दमाले	दामले
damle	डमले	दामले
dayitv	दयित्व	दायित्व
dayitva	दयित्व	दायित्व
dayitwa	दयित्व	दायित्व
dayitvon	दयित्वों	दायित्वों
dayityon	दयित्यों	दायित्वों
darul	दरुल	दारूल
daav	दाव	दाव
daaw	दाव	दाव
dav	दाव	दाव
daw	दाव	दाव
daah	दाह	दाह
dah	दाह	दाह
dikhla	दिखला	दिखला
dikhlaa	दिखला	दिखला
dikhaaiye	दिखाइए	दिखाइये
dikhaiye	दिखाए	दिखाइये
dikhaai	दिखाई	दिखाई
dikhai	दिखाई	दिखाई
dikhayi	दिखाई	दिखाई
dikhaaee	दिखाई	दिखाईं
dikhaai	दिखाई	दिखाईं
dikhaain	दिखाएं	दिखाईं
dikhaee	दिखाई	दिखाईं
dikhai	दिखाई	दिखाईं
dikhayin	दिखाएं	दिखाईं
dikhai	दिखाई	दिखायी
dikhayi	दिखाई	दिखायी
dikhaai	दिखाई	दिखार्इ
dikhae	दिखाए	दिखार्इ
dikhai	दिखाई	दिखार्इ
dikhayi	दिखाई	दिखार्इ
dita	दीता	दिता
ditaa	दीता	दिता
dinaank	दिनांक	दिनांक
dinank	दिनांक	दिनांक
dirham	दीरहम	दिरहम
dilaaye	दिलाए	दिलाये
dilaye	दिलाए	दिलाये
deewani	दीवानी	दिवानी
diwani	दिवानी	दिवानी
divy	दिव्य	दिव्य
divya	दिव्य	दिव्य
divyata	दिव्यता	दिव्यता
divya	दिव्य	दिव्या
deepan	दीपन	दीपन
deepn	दीपन	दीपन
dipan	दीपन	दीपन
deepsingh	दीपसिंघ	दीपसिंह
dipsingh	दीपसिंघ	दीपसिंह
deepika	दीपिका	दीपिका
dipika	दीपिका	दीपिका
deeya	दीया	दीया
diya	दिया	दीया
dukaanon	दुकानों	दुकानों
dukanon	दुकानों	दुकानों
dukke	दुक्के	दुक्के
dukhan	दुखान	दुखन
dukhit	दुखित	दुखित
dukhiyon	दुखियोंं	दुखियों
dukhon	दुखों	दुखों
dubhashiyon	दुभाषियों	दुभाषियों
durgun	दुर्गुन	दुर्गुण
durghatna	दूर्घनता	दुर्घटना
durghtna	दूर्घनता	दुर्घटना
duneerti	दुनीरती	दुर्नीति
durniti	दुर्णीति	दुर्नीति
durbhiksh	दुरभभिक्ष	दुर्भिक्ष
duvidhaaen	दुविधाएं	दुविधाएं
duvidhaayein	दुविधाएं	दुविधाएं
duvidhaen	दुविधाएं	दुविधाएं
duwaidhaayein	दुवाधाएं	दुविधाएं
dune	दूने	दूने
doordarshan	दूरदर्शन	दूरदर्शन
durdarshan	दुरदर्शन	दूरदर्शन
dradh	द्राध	दृढ़
dridh	द्रीध	दृढ़
dekhoge	डेखोगे	देखोगे
denevaali	देनेवाली	देनेवाली
denevali	देनेवाली	देनेवाली
denewaali	देनेवाली	देनेवाली
denewali	देनेवाली	देनेवाली
deonar	देयनन	देवनार
devnaar	देवनार	देवनार
devnar	देवनार	देवनार
devaapur	देवापुर	देवापुर
devapur	देवापुर	देवापुर
devi	देवी	देवी
devisingh	देविजिंघ	देवीसिंह
devisinh	देविजिन	देवीसिंह
deshkaal	देशकाल	देशकाल
deshkal	देशकाल	देशकाल
deshke	देशके	देशके
desai	देसाई	देसाई
doge	डोग	दोगे
dvadash	द्वादश	द्वादश
dwaadas	द्वादस	द्वादश
dvivedi	द्विवेदी	द्विवेदी
dwivedi	द्विवेडी	द्विवेदी
dhande	ढाडे	धंधे
dhandhe	ढांधे	धंधे
dhndhe	ढंधे	धंधे
dhandhon	धनंधों	धंधों
dhandon	धनडों	धंधों
dhakelte	ढकेलते	धकेलते
dhkelate	धकेलते	धकेलते
dhatana	ढतना	धटना
dhatna	ढतना	धटना
dhankuber	धनंकुबर	धनकुबेर
dhanadhany	धनाधन्य	धनधान्य
dhandhaanya	धनधान्य	धनधान्य
dhandhany	धनंधन्य	धनधान्य
dhandhanya	धनधन्य	धनधान्य
dhamkaataa	धमकाता	धमकाता
dhamkata	धमकता	धमकाता
dhamm	धम्म	धम्म
dhamma	धम्मा	धम्मा
dhammaa	धम्मा	धम्मा
dharmnath	धर्मनाथ	धर्मनाथ
dharmraj	धर्मराज	धर्मराज
dharmesh	धर्मेश	धर्मेश
dhasmaanaa	धस्माना	धस्माना
dhasmana	धस्माना	धस्माना
dhaak	धाक	धाक
dhak	ढक	धाक
dhaaga	ढागा	धागा
dhaagaa	धागा	धागा
dhaga	ढागा	धागा
dhaatuein	धातुएं	धातुएं
dhaatuyein	धातुएं	धातुएं
dhtuen	धतुएं	धातुएं
dhaarak	धारक	धारक
dharak	धारक	धारक
dhaari	धारी	धारी
dhari	धारी	धारी
dhuan	धुआन	धुआं
dhunaai	धुनाई	धुनाई
dhunai	धुनाई	धुनाई
dhuriya	धूरिया	धुरिया
dhuriyaa	धूरिया	धुरिया
dhuni	धुनी	धूनी
dhairyavaan	धैर्यवान	धैर्यवान
dhairyawan	धैर्यवन	धैर्यवान
dhiryavan	धीर्यवन	धैर्यवान
dhiryawaan	धीर्यवान	धैर्यवान
dhokebaaj	धोकेबाज	धोखेबाज
dhokebaaz	धोकेबाज़	धोखेबाज
dhokebaj	धोकेबाज	धोखेबाज
dhokebaz	धोकेबाज़	धोखेबाज
dhokhebaaj	धोखेबाज	धोखेबाज
dhokhebaj	धोखेबाज	धोखेबाज
dhona	ढोना	धोना
dhonaa	धोना	धोना
dhoraaji	धोराजी	धोराजी
dhoraji	धोराजी	धोराजी
dhoron	धोरों	धोरों
dhyeyavaadi	ध्येवादी	ध्येयवादी
dhyeywadi	ध्येवादी	ध्येयवादी
dyeyvadi	द्येवादी	ध्येयवादी
dhrupad	धृपद	ध्रुपद
drupad	दृपद	ध्रुपद
nandanvan	नंदनवन	नंदनवन
nadsa	नाससा	नक्सल
naksal	नकसाल	नक्सल
naxal	नक्सल	नक्सल
naksalavaad	नकसालवाद	नक्सलवाद
naksalwaad	नकसालवाद	नक्सलवाद
naksalwad	नकसालवाद	नक्सलवाद
naxalvaaad	नकसलवाद	नक्सलवाद
naxalwaad	नक्लावाद	नक्सलवाद
naksaliyon	नकसालियों	नक्सलियों
naxaliyon	नक्लायों	नक्सलियों
naksali	नकसाली	नक्सली
naxali	नकाली	नक्सली
nagaada	नगाड़ा	नगाड़ा
nagaadaa	नगाड़ा	नगाड़ा
nagaaraa	नगारा	नगाड़ा
nageene	नगीने	नगीने
nagine	नागनन	नगीने
najarandaaj	नजरनंदाज	नजरंदाज
najarandaaz	नजरनंदाज	नजरंदाज
nazarandaaj	नजरनंदाज	नजरंदाज
nazarandaaz	नजरनंदाज	नजरंदाज
nazarandaz	नज़रंदाज	नजरंदाज
najraane	नजराने	नजराने
nazraane	नज़ाने	नजराने
najariyon	नजारियों	नजरियों
najriyon	नजरियों	नजरियों
najron	नजरों	नजरों
najeeb	नजीब	नजीब
najib	नजीब	नजीब
najibabaad	नजीबबाब	नजीबाबाद
najibabad	नजीबबाब	नजीबाबाद
najeem	नजीम	नजीम
najim	नजजिम	नजीम
nazeem	नजीम	नजीम
nana	नाना	नना
nanaa	नना	नना
nna	ननएए	नना
nanhe	नानहे	नन्हें
nanhein	नानहें	नन्हें
nabj	नब्ज	नब्ज़
nabja	नब्जा	नब्ज़
nabz	नब्ज	नब्ज़
namkeen	नमकीन	नमकीन
namkin	नमकीन	नमकीन
narnaari	नरनारी	नरनारी
narnari	नरनारी	नरनारी
narbhakshi	नरभक्षी	नरभक्षी
naram	नारम	नरम
narm	ना्म	नरम
narmi	नार्मी	नरमी
narsanhar	नरसंहर	नरसंहार
narsanharon	नरसंहारों	नरसंहारों
november	नॉवेबर	नवंबर
navketan	नवकेटन	नवकेतन
navjaagaran	नवजागरण	नवजागरण
navjagran	नवजज्रन	नवजागरण
navdha	नवधा	नवधा
navvadhoo	नववाधू	नववधू
navvadhu	नववाधु	नववधू
nava	नवा	नवा
navaa	नवा	नवा
navate	नवते	नवाते
navanagar	नवनगर	नवानगर
nawanagar	नवनगर	नवानगर
navya	नव्य	नव्या
naseem	नसीम	नसीम
nasim	नसीम	नसीम
nights	नाइट्सस	नाइट्रस
nitrous	नाइट्रोजसस	नाइट्रस
nineteez	निनेटीज	नाइनटीज
nineties	नाइनेटिज	नाइनटीज
ninties	निंटीज	नाइनटीज
nau	नौ	नाऊ
nauu	नौऊ	नाऊ
naakaam	नाकाम	नाकाम
nakam	नकम	नाकाम
naagrik	नाग्रिक	नागारिक
nagarik	नागरिक	नागारिक
nagrik	नागरिक	नागारिक
nagin	नागीन	नागिन
nadep	नेडप	नाडेप
nanak	ननक	नानक
nanavati	ननवती	नानावती
napane	नापने	नापने
napne	नापने	नापने
napa	नापा	नापा
naam	नाम	नाम
naamdhari	नामधारी	नामधारी
namdhari	नममारी	नामधारी
namankano	नमानकनों	नामांकनों
namankanon	नमानकनों	नामांकनों
namavaliyon	नमावलियों	नामावलियों
naamo	नामो	नामो
namo	नमो	नामो
nayak	नायक	नायक
naraji	नारजी	नाराजी
naraingarh	नरेंगढ़	नारायणगढ़
narayangadh	नरायंगढ़	नारायणगढ़
narayangarh	नरायंगढ़	नारायणगढ़
naasar	नासर	नासर
nahargadh	नहरगढ़	नाहरगढ
nahargarh	नहरगढ़	नाहरगढ
nikalegi	निकलेगी	निकलेगी
nikalogi	निकलोगी	निकलेगी
nikaalani	निकालनी	निकालनी
nikaalni	निकालनी	निकालनी
nikalani	निकाली	निकालनी
nikalni	निकलनी	निकालनी
nicki	निकी	निकी
nicky	नीकीी	निकी
niki	नीकी	निकी
niketan	निकेटन	निकेतन
nikhar	निखर	निखर
nikhari	निखारी	निखरी
nigar	निगर	निगर
nigger	नाइगर	निगर
nichala	निचला	निचला
nichalaa	निचला	निचला
nichla	नीचला	निचला
nitiyon	नितियों	नितियों
nitya	नित्य	नित्या
nityaa	नित्या	नित्या
nidhaan	निधान	निधान
nidhan	निधन	निधान
nipatara	निपतारा	निपटारा
niptaara	निपतारा	निपटारा
niptaaraa	निपतारा	निपटारा
niptara	निपतारा	निपटारा
niyanta	नियंता	नियंता
niyantaa	नियंता	नियंता
niya	नीया	निया
niyaa	निया	निया
nirdeshika	निर्देशिका	निर्देशिका
nirdeshikaa	निर्देशिका	निर्देशिका
nirdhaarit	निर्धारित	निर्धारित
nirdharit	निर्धारित	निर्धारित
nirbaadh	निर्बाध	निर्बाध
nirbadh	निर्बाध	निर्बाध
niveshakartaa	निवेशकर्ता	निवेशकर्ता
niveshkarta	निवेशकर्ता	निवेशकर्ता
niveshkartaa	निवेशकर्ता	निवेशकर्ता
nischal	निस्कल	निश्चल
nishchal	निश्चल	निश्चल
nishnaat	निश्नत	निष्णात
nishpaap	निशपाप	निष्पाप
nihalaani	निहालनी	निहलानी
nihlaani	निहलानी	निहलानी
nihlani	निहलानी	निहलानी
nihaalchand	निहालचंद	निहालचंद
nihalchand	निहालचंड	निहालचंद
neechaaee	नीचाई	नीचाई
nichaai	निचाई	नीचाई
neat	नेट	नीट
neet	नीत	नीट
neetiyon	नीतियों	नीतियों
nitiyon	नितियों	नीतियों
neelagaay	नीलाए	नीलगाय
nilgai	नीलगाई	नीलगाय
neelaabh	नीलाभ	नीलाभ
nilaabh	नीलाभ	नीलाभ
nilabh	नीलाभ	नीलाभ
nuskhe	नुश्के	नुस्खे
noon	नून	नून
nun	नन	नून
noobiyaa	नूबिया	नूबिया
nubiya	नुबिया	नूबिया
nrityashaili	नृत्याशाली	नृत्यशैली
nrutyashaili	नृत्याशाली	नृत्यशैली
nrityon	नृत्यों	नृत्यों
nrutyon	नृत्यों	नृत्यों
neco	नेको	नेको
neko	नेको	नेको
nectar	नेक्टर	नेक्टर
neg	नेग	नेग
nega	नेगा	नेग
networking	नेटवर्किंगगग	नेटवर्किग
neto	नेटो	नेटो
neta	नेता	नेता
nemo	नेमो	नेमो
nelsan	नेल्सन	नेल्सन
nelson	नेल्सन	नेल्सन
nations	नैशनंस	नेशंस
nehara	नेहरा	नेहरा
nehra	नेहरा	नेहरा
naino	नैनो	नैनो
nano	नननो	नैनो
naivedh	नैवेध	नैवेद्य
naivegh	नैवेघ	नैवेद्य
nevedya	नेवेद्या	नैवेद्य
nominate	नॉमिनेट	नॉमिनेट
naukari	नौकारी	नोकरी
naukri	नौकरी	नोकरी
nokari	नोकारी	नोकरी
nokri	नोकरी	नोकरी
notes	नॉट्स	नोट्स
nora	नोरा	नोरा
nori	नॉरी	नोरी
nauner	नॉनर	नौनेर
nauvahan	नौवाहन	नौवहन
naushad	नौशद	नौशाद
panchaang	पंचांग	पंचांग
panchang	पंचांग	पंचांग
punchang	पंचांग	पंचांग
punjab	पुंजब	पंजाब
punjabiyon	पुंजबियों	पंजाबियों
pantar	पंंतर	पंटर
panter	पंंटर	पंटर
punter	पंटर	पंटर
pakaayein	पकाएं	पकाएं
pakaayen	पकाएं	पकाएं
pakaen	पकाएं	पकाएं
pakayen	पकाएं	पकाएं
pakaude	पकौड़े	पकौड़े
pakshapat	पक्षपत	पक्षपात
pakshpaat	पक्षपात	पक्षपात
pakshpat	पक्षपत	पक्षपात
pagabadha	पगबाधा	पगबाधा
pagbadha	पगबाधा	पगबाधा
pagalaa	पगला	पगला
pagla	पगला	पगला
pachaataa	पचाता	पचाता
pachata	पचाता	पचाता
patakkar	पतककार	पटककर
patkathaayein	पतकथाएं	पटकथाएं
patkathaein	पतकथाएं	पटकथाएं
patkathayen	पतकथाएं	पटकथाएं
patki	पतकी	पटकी
pataraani	पतरानी	पटरानी
patrani	पत्रानी	पटरानी
patavaari	पतवारी	पटवारी
patwari	पतवारी	पटवारी
pataakshep	पताक्षेप	पटाक्षेप
patachep	पतचेप	पटाक्षेप
patakshep	पतक्षेप	पटाक्षेप
patiya	पतिया	पटिया
patiyaa	पतिया	पटिया
padaraunaa	पदाराणा	पडरौना
padrauna	पद्रौना	पडरौना
padega	पदेगा	पड़ेगा
padegaa	पदेगा	पड़ेगा
padha	पढ़ा	पढ़ा
padhaa	पढ़ा	पढ़ा
padhaataa	पढ़ाता	पढ़ाता
padhata	पढ़ता	पढ़ाता
patili	पतिली	पतीली
padamawati	पदमावती	पदमावती
padmavati	पदमावती	पदमावती
padmawati	पदमावती	पदमावती
padadhikari	पदाधिकारी	पदाधिकारी
panapnaa	पनपना	पनपना
panpana	पनपना	पनपना
panaamaa	पनामा	पनामा
panama	पनमा	पनामा
paneer	पनीर	पनीर
pammi	पम्मी	पम्मी
pammu	पम्मू	पम्मी
pummi	पम्मी	पम्मी
pummy	पम्मी	पम्मी
pardesiyon	पर्देसियों	परदेसियों
pardesi	पर्देसी	परदेसी
parva	परवा	परवा
parvaa	परवा	परवा
parwa	परवा	परवा
parwaa	परवा	परवा
paraadheen	पराधीन	पराधीन
paraadhin	पराधीन	पराधीन
paradheen	पराधीन	पराधीन
paradhin	पराधीन	पराधीन
parikalpit	परिकल्पित	परिकल्पित
parimal	परिमल	परिमल
parishad	परिषद	परिषद
parishadiy	परिशदीय	परिषदीय
parishadiya	परिशदीय	परिषदीय
parishadon	परिशदों	परिषदों
parikhaen	परिखाएं	परीक्षाएं
parikshaayein	परिक्षाएं	परीक्षाएं
parikshaen	परिक्षाएं	परीक्षाएं
parosane	परोसने	परोसने
parosne	परोसने	परोसने
parda	परदा	पर्दा
pardaa	परदा	पर्दा
purple	पुर्पल	पर्पल
palatne	पलतने	पलटने
paltane	पलतने	पलटने
palaari	पलारी	पलारी
palari	पाारी	पलारी
pale	पाले	पले
palmonari	पलमोनारी	पल्मोनरी
pulmonary	पुल्मोनरी	पल्मोनरी
plus	प्लूस	पल्स
pulse	पुल्स	पल्स
pashtun	पश्तुन	पश्तून
pashtuun	पश्तुन	पश्तून
pahan	पहन	पहन
pehan	पहन	पहन
pahantaa	पहनता	पहनता
pahnata	पहनाता	पहनता
pehnate	पहनते	पहनता
pahanate	पहनते	पहनते
pahante	पहनते	पहनते
pehnate	पहनते	पहनते
pahnaakar	पहनाकर	पहनाकर
pahnakar	पहनाकार	पहनाकर
pehnakar	पहनाकर	पहनाकर
pahnaati	पहनाती	पहनाती
pahnati	पहनती	पहनाती
pehnati	पहनती	पहनाती
pahani	पहनी	पहनी
pahni	पहनी	पहनी
pehni	पहनी	पहनी
pahno	पहनो	पहनो
pehno	पहनो	पहनो
pahla	पहला	पहला
pahlaa	पहला	पहला
pehla	पहला	पहला
paheliyaan	पहेलियां	पहेलियां
paheliyan	पहेलियां	पहेलियां
paheliyon	पहेलियों	पहेलियों
pide	पीड	पाइड
pied	पीए	पाइड
pythagoras	प्थाागोर्स	पाइथागोरस
pythogaras	प्थथोगरस	पाइथागोरस
paakhandi	पाखंडी	पाखंडी
pakhandi	पखांडी	पाखंडी
paathshaalaayein	पाठशालाएं	पाठशालाएं
pathshalayein	पथशालाएं	पाठशालाएं
pathshalayen	पथशालाएं	पाठशालाएं
paathyakram	पाठ्यक्रम	पाठ्यक्रम
pathyakram	पथ्यक्रम	पाठ्यक्रम
pathykram	पथ्यक्रम	पाठ्यक्रम
paathyakramon	पाठ्यक्रमों	पाठ्यक्रमों
pathyakramon	पथ्यक्रमों	पाठ्यक्रमों
pathykramon	पथ्यक्रमों	पाठ्यक्रमों
population	पोपुलेशन	पापुलेशन
pailot	पैलोट	पायलट
pilot	पिलोट	पायलट
pailoton	पैलोटन	पायलटों
piloton	पिलोटों	पायलटों
paarampariktaa	पारंपरिकता	पारंपरिकता
paramparikata	परंपरिकता	पारंपरिकता
paramparikta	परंपरिकता	पारंपरिकता
parnel	पर्नेल	पार्नेल
parnell	पर्नेल	पार्नेल
parleron	परलररों	पार्लरों
parloron	परलोरों	पार्लरों
parlouron	परलौरों	पार्लरों
paarshad	पार्शद	पार्षद
parshad	पर्शद	पार्षद
paarshadon	पार्शदों	पार्षदों
parshadon	पर्शदों	पार्षदों
parshdon	पर्शदों	पार्षदों
policy	पॉलिसीी	पालिसी
pinta	पिंता	पिंटा
pintaa	पिंता	पिंटा
piega	पीगा	पिएगा
piyegaa	पिएगा	पिएगा
pic	पीकी	पिक
pick	पिकक	पिक
pik	पिक	पिक
piki	पिकी	पिकी
piky	पिक्य	पिकी
picture	पिक्टूर	पिक्चर
pigmentation	पिगमेंटेशन	पिगमेंटेशन
pigs	पाग्स	पिग्स
pichde	पिछड़े	पिछड़े
pichhade	पिछड़े	पिछड़े
pijja	पीजजा	पिज्जा
pizza	पीज़ा	पिज्जा
pitaamaha	पितामह	पितामह
pitamah	पितमह	पितामह
pipra	पीपरा	पिपरा
pipraa	पिप्रा	पिपरा
pipli	पिपली	पिपली
pearson	पेर्सन	पियरसन
pierson	पीयर्सन	पियरसन
peary	पीरी	पियरी
piyari	पियारी	पियरी
pisaai	पिसाई	पिसाई
pisai	पिसाई	पिसाई
pihaani	पिहानी	पिहानी
pihani	पिहनी	पिहानी
pib	पीब	पीआईबी
pr	प्र	पीआर
pml	पीएलएल	पीएमएल
pmo	पीएम	पीएमओ
pmch	पीमचच	पीएमसीएच
psv	पीएसवीी	पीएसवी
peaking	पीकिंग	पीकिंग
picking	पिकिंग	पीकिंग
peetne	पीटने	पीटने
pitne	पिटने	पीटने
pedia	पेडिया	पीडिया
pidiya	पीड़िया	पीडिया
pidiyaa	पीड़िया	पीडिया
peelepan	पीलेपन	पीलेपन
pilepan	पीलेपन	पीलेपन
pv	पीवीीी	पीवी
pisa	पीसा	पीसा
putla	पूतला	पुतला
putlaa	पुतला	पुतला
putaliyaan	पुतलियां	पुतलियां
putliyan	पुतलीयां	पुतलियां
putaliyon	पुतलियों	पुतलियों
putliyon	पुतलियों	पुतलियों
putali	पुताली	पुतली
putli	पुतली	पुतली
putale	पुटाले	पुतले
putle	पुटल	पुतले
putin	पुटिन	पुतिन
putul	पुतुल	पुतुल
punargathan	पुनर्गठनन	पुनर्गठन
puna	पुना	पुना
puraane	पुराने	पुराने
purane	पूराने	पुराने
puru	पूरू	पुरू
purjon	पूर्जों	पुर्जों
purzon	पूर्जों	पुर्जों
pulam	पुलम	पुलम
pushkin	पुष्किन	पुश्किन
pushkarana	पुष्करण	पुष्करणा
pushkarna	पुष्करण	पुष्करणा
pushkarnaa	पुष्करणा	पुष्करणा
pushp	पुष्प	पुष्प
pushpa	पुष्प	पुष्प
pushpa	पुष्प	पुष्पा
pushpaa	पुष्पा	पुष्पा
pushpit	पुष्पित	पुष्पित
pushpon	पुष्पों	पुष्पों
poonjikaran	पूंजीकरण	पूंजीकरण
punjikaran	पुंजीकरण	पूंजीकरण
poojaapaath	पूजापठ	पूजापाठ
poojapath	पूजापथ	पूजापाठ
pujapath	पुजापथ	पूजापाठ
pooranpur	पूरंपुर	पूरनपुर
puranpur	पुरांपुर	पूरनपुर
purvaabhaas	पुर्वाभास	पूर्वाभास
purvaabhas	पुर्वाभास	पूर्वाभास
purvabhaas	पुर्वााास	पूर्वाभास
purvabhas	पुर्वाभास	पूर्वाभास
pendulam	पेंदुलम	पेंडुलम
pendulum	पेंदुलुम	पेंडुलम
peg	पेग	पेग
pages	पैज्स	पेजेज
pajej	पजेज	पेजेज
pace	पेस	पेस
pes	पेस	पेस
pastry	पास्त्री	पेस्ट्री
pangolin	पंगोलिन	पैंगोलिन
pengolin	पेंगोलिन	पैंगोलिन
packard	पैकार्ड	पैकर्ड
package	पैकेज	पैकेज
packageon	पैकाेजन	पैकेजों
packagon	पक्कागों	पैकेजों
packajon	पक्ाजों	पैकेजों
paim	पैम	पैम
pam	पम	पैम
paratrooper	परत्रूपर	पैराट्रूपर
peratrupers	पेरेट्रूपर्स	पैराट्रूपर
paranormal	परणोर्मल	पैरानॉर्मल
peranormal	पेरनोर्मल	पैरानॉर्मल
paraffin	परफफीन	पैराफिन
parafin	परफीन	पैराफिन
perafin	पेरफीन	पैराफिन
parabola	परबोला	पैराबोला
perabola	पेरबोला	पैराबोला
polimer	पॉलिमर	पॉलिमर
polymer	पॉलीमर	पॉलिमर
polishing	पोलिशिंगगग	पॉलिशिंग
pokar	पोकर	पोकर
poker	पोकर	पोकर
polish	पोलिश	पोलिश
poshit	पोशित	पोषित
posta	पोस्ता	पोस्ता
pau	पाऊ	पौ
pyade	प्याद	प्यादे
prakriya	प्रक्रिया	प्रक्रिया
prakshepak	प्रक्षेपक	प्रक्षेपक
pratigya	प्रतिज्ञा	प्रतिज्ञा
prtigyaa	प्रतिज्ञा	प्रतिज्ञा
pratibhutiyan	प्रतिभूतियां	प्रतिभूतियां
pratiyon	प्रतियोंं	प्रतियों
prativaad	प्रतिवाद	प्रतिवाद
prativad	प्रतिवाद	प्रतिवाद
prativadi	प्रतिवादी	प्रतिवादी
pratishat	प्रतिष्ट	प्रतिशत
praneet	प्रणीत	प्रनीत
pranit	प्रणित	प्रनीत
prapaat	प्रपात	प्रपात
prapat	प्रपत	प्रपात
prapaaton	प्रपातों	प्रपातों
prapaton	प्रपतों	प्रपातों
prabodhini	प्रबोधिनी	प्रबोधिनी
prayaasrat	प्रयास्रत	प्रयासरत
prayasarat	प्रयसरत	प्रयासरत
pradarshan	प्रदर्शन	प्रर्दशन
prardashan	प्रारदशान	प्रर्दशन
pravati	प्रवती	प्रवत्ति
pravatti	प्रवत्ति	प्रवत्ति
prashaasanik	प्रशासनिक	प्रशासनिक
prashasanik	प्रशासनिक	प्रशासनिक
prashasnik	प्रशासनिक	प्रशासनिक
prashaasanon	प्रशासनों	प्रशासनों
prashansanon	प्रशंसनों	प्रशासनों
prashasanon	प्रशासनों	प्रशासनों
prashikshu	प्रशिक्षु	प्रशिक्षु
prastaavon	प्रस्तावों	प्रस्तावों
prastavon	प्रस्तावों	प्रस्तावों
prahlaad	प्रहलाद	प्रहलाद
prahlad	प्रहला	प्रहलाद
prahasan	प्रहसन	प्रहसन
prahsan	प्रासन	प्रहसन
prahaarak	प्रहारक	प्रहारक
praharak	प्रहरक	प्रहारक
prahad	प्रहाद	प्रह्लाद
prahlad	प्रहला	प्रह्लाद
privacy	प्रिवेसी	प्राइवेसी
praakkathan	प्रक्खान	प्राक्कथन
prakkathan	प्रक्कठान	प्राक्कथन
praan	प्राण	प्राण
pran	प्राण	प्राण
pranon	प्राणों	प्राणों
prathamik	प्रथामिक	प्राथमिक
prathmik	प्रथ्मिक	प्राथमिक
praathmikata	प्राथमीकता	प्राथमिकता
prathmikta	प्रथम्मिकता	प्राथमिकता
prathmiki	प्रथम्मिकी	प्राथमिकी
pradhyapakon	प्राध्यापकों	प्राध्यापकों
prapt	प्रप्त	प्राप्त
prapta	प्रपता	प्राप्त
prapti	प्रपती	प्राप्ती
praroop	प्रारूप	प्रारूप
prarup	प्रारूप	प्रारूप
priyamani	प्रियमानी	प्रियामणि
proof	प्रूफ	प्रूफ
pruf	प्रूफ	प्रूफ
prekshakon	प्रेक्षकों	प्रेक्षकों
prem	प्रेम	प्रेम
premlata	प्रेमलाता	प्रेमलता
prema	प्रेमा	प्रेमा
premi	प्रेमी	प्रेमी
profit	प्रोफिट	प्रॉफिट
processing	प्रॉसेसिंग	प्रॉसेसिंग
programers	प्रोग्रामर्स	प्रोग्रामर्स
programmers	प्रोग्राम्रस	प्रोग्रामर्स
programs	प्रोग्राम्स	प्रोग्रामर्स
proto	प्रोटो	प्रोटो
propellant	प्रोपेलेंट	प्रोपेलेंट
propellent	प्रोपेलेंट	प्रोपेलेंट
praudh	प्रौढ़	प्रौढ
proud	प्रुड	प्रौढ
plan	प्लान	प्लेन
plane	प्लेन	प्लेन
fund	फंंड	फंड
funda	फुंडा	फंडा
funding	फंडिंग	फंडिंग
fandon	फंंडों	फंदों
fagua	फगगु	फगुआ
fatane	फटने	फटने
phatane	फटने	फटने
phatne	फटने	फटने
fadfadata	फड़फा़ता	फड़फड़ाता
phadphadata	फड़फाड़ता	फड़फड़ाता
fatehgadh	फतेगढ़	फतेहगढ़
fatehgarh	फतेहरढ़	फतेहगढ़
fabti	फबती	फब्ती
phabti	फब्ती	फब्ती
farse	फर्स	फरसे
pharase	फरासे	फरसे
pharse	फर्से	फरसे
farheen	फरहीन	फरहीन
farhin	फरहीन	फरहीन
farth	फरर्थ	फर्थ
ferth	फेर्थ	फर्थ
pharth	फरर्थ	फर्थ
farmion	फर्मियन	फर्मिऑन
fermion	फे्मियन	फर्मिऑन
firmian	फा्मियन	फर्मिऑन
farookhabad	फरूखाबाद	फर्रुखाबाद
farrukhabad	फरुखाबाद	फर्रुखाबाद
farukhabad	फरुखाबाद	फर्रुखाबाद
farookhnagar	फरूखनागर	फर्रूखनगर
farrukhnagar	फरुखनागर	फर्रूखनगर
farukhnagar	फरुखनागर	फर्रूखनगर
falata	फलता	फलता
falta	फलता	फलता
phalata	फलता	फलता
falne	फलने	फलने
phalne	फलने	फलने
falitarth	फलितर्थ	फलितार्थ
phalitartha	फलितर्थ	फलितार्थ
falibhoot	फलिभूत	फलीभूत
falibhut	फलिभूत	फलीभूत
phalibhoot	फलिभूत	फलीभूत
favvara	फववारा	फव्वारा
fawaara	फवारा	फव्वारा
favvare	फववेरे	फव्वारे
fawaare	फवारे	फव्वारे
favvaron	फववरों	फव्वारों
fawaaron	फवारों	फव्वारों
faisala	फैसला	फ़ैसला
faisla	फैसला	फ़ैसला
follow	फोलो	फ़ॉलो
faansi	फांसी	फांसी
fansi	फनसी	फांसी
fatama	फटमा	फातमा
fatma	फटमा	फातमा
faaf	फाफ	फाफ
phaaph	फाफ	फाफ
farsi	फर्सी	फारसी
forcee	फोर्सी	फारसी
farm	फर्म	फार्म
form	फॉर्म	फार्म
farmic	फर्मिक	फार्मिक
formic	फोर्मिक	फार्मिक
formulae	फोरमुले	फार्मूले
formule	फोर्मूल	फार्मूले
formuley	फोरमलूली	फार्मूले
pharmacy	फर्मेसीी	फार्मेसी
pharma	फर्मा	फार्मों
pharmon	फर्मों	फार्मों
farms	फर्म्स	फार्म्स
finger	फाइंगर	फिंगर
fikra	फिक्र	फिक्र
physician	फिजिसियन	फिजिशियन
firti	फिर्ती	फिरती
fisla	फिस्ला	फिसला
fislaa	फिस्ला	फिसला
feeder	फीडर	फीडर
fulaaye	फुलाए	फुलाए
fulae	फुलाई	फुलाए
fulay	फुलय	फुलाए
furti	फुर्ती	फूर्ति
phurti	फूर्ती	फूर्ति
fus	फस	फूस
phoos	फूस	फूस
phus	फूस	फूस
feka	फेका	फेका
fefada	फेफड़ा	फेफड़ा
fefda	फेफड़ा	फेफड़ा
facial	फैसियल	फेशियल
fact	फैक्ट	फैक्ट
federal	फेडरल	फैडरल
failkar	फैलकर	फैलकर
failaaiye	फैलाइए	फैलाइए
failaea	फैलाई	फैलाइए
failaiya	फैलाया	फैलाइए
failaiye	फैलाइ	फैलाइए
failegi	फैलेगी	फैलेगी
font	फॉंटट	फॉन्ट
fogat	फोगत	फोगाट
phogat	फोगत	फोगाट
fod	फोड़	फोड़
phod	फोड़	फोड़
foda	फोड़ा	फोड़ा
fodaa	फोड़ा	फोड़ा
phoda	फोड़ा	फोड़ा
fode	फोड़	फोड़े
phode	फोड़े	फोड़े
fodo	फोडो	फोड़ों
fodon	फोड़ों	फोड़ों
phodo	फोड़ो	फोड़ों
fortis	फोर्टिसस	फोर्टिस
fusion	फससियन	फ्यूजन
fuji	फुजी	फ्यूजी
fyuji	फ्यूजी	फ्यूजी
francisca	फ्रांसिस्का	फ्रांसिस्का
franciska	फ्रांसिस्का	फ्रांसिस्का
fransiska	फ्रांसिस्का	फ्रांसिस्का
francisco	फ्रेंसिस्को	फ्रांसिस्को
francisko	फ्रेंसिस्को	फ्रांसिस्को
fransisko	फ्रांसिसको	फ्रांसिस्को
fringe	फ्रिंग	फ्रिंज
friendship	फ्रेंदशशप	फ्रेंडशिप
frost	फ्रॉस्ट	फ्रॉस्ट
flin	फ्लाइन	फ्लिन
flynn	फ्लाननन	फ्लिन
flesh	फ्लेश	फ्लेश
bang	बंंग	बंग
bung	बंग	बंग
bangbandhu	बंगबंधु	बंगबंधु
bangbhang	बंगभंग	बंगभंग
bangash	बंगाश	बंगश
bangsh	बंगश	बंगश
bantane	बंटने	बंटने
bantne	बंंटने	बंटने
bandhati	बंधती	बंधती
bandhti	बंधती	बंधती
bandhan	बंधन	बंधान
bandhuon	बंधुओं	बंधुओं
bamba	बांबा	बंबा
mumba	मुंबा	बंबा
bakaayon	बकायों	बकायों
bakayon	बकायों	बकायों
bakaul	बकौल	बकौल
bakoul	बककल	बकौल
baksa	बकसा	बक्सा
baksi	बकसी	बक्सी
bakse	बकसे	बक्से
bakhshane	बख़शाने	बख्शने
bakhshne	बख़्शने	बख्शने
bagad	बगद	बगड़
bagd	बगद	बगड़
bageechi	बगीची	बगीची
bagichi	बगगीची	बगीची
bachat	बचात	बचत
bachati	बचाती	बचती
bachti	बच्ति	बचती
bajana	बजना	बजना
bajrangi	बजरंगी	बजरंगी
bajaj	बजजज	बजाज
batalvi	बतलवी	बटालवी
badhachadhakar	बढ़चाधकर	बढ़ाचढ़ाकर
badata	बद़ता	बढ़ाता
badhaataa	बढ़ता	बढ़ाता
badhata	बढ़ता	बढ़ाता
badhaati	बढ़ाती	बढ़ाती
badhati	बढ़ती	बढ़ाती
badhayi	बढ़ाई	बढ़ायी
badhav	बढ़ाव	बढ़ाव
badhotari	बढ़ोतरी	बढ़ोतरी
badhotri	बाधोत्री	बढ़ोतरी
batlaae	बतलाई	बतलाए
batlaaye	बतलाए	बतलाए
batlae	बतलाई	बतलाए
batlaye	बतलाए	बतलाए
batlaakar	बतलाकर	बतलाकर
batlakar	बतलाकर	बतलाकर
badlapur	बदलापुर	बदलापुर
badali	बदली	बदली
badli	बदली	बदली
badam	बदम	बदाम
banva	बनवा	बनवा
banvaa	बनवा	बनवा
banaam	बनाम	बनाम
banam	बनम	बनाम
bnaam	बनाम	बनाम
baniya	बननिया	बनिया
banu	बानू	बनू
barpaayaa	बरपाया	बरपाया
barpaya	बरपाया	बरपाया
barsa	बर्सा	बरसा
barsaata	बरसाता	बरसाता
barsaataa	बरसाता	बरसाता
barsata	बरसता	बरसाता
barhad	बरहद	बरहद
baraat	बरात	बरात
barat	बारत	बरात
braat	ब्रत	बरात
baraamad	बरामद	बरामद
baramad	बरामद	बरामद
bramad	ब्रामद	बरामद
baramade	बरामेड	बरामदे
baramde	बरामड़े	बरामदे
bare	बेरे	बरे
birth	बीर्थ	बर्थ
baljeet	बलजीत	बलजीत
baljit	बलजीत	बलजीत
ballabh	बल्लभ	बल्लभ
balla	बल्ला	बल्ला
balli	बलली	बल्ली
basava	बसवा	बसावा
bastiyon	बस्तियोंं	बस्तियों
bahroopiya	बहरूपिय	बहरूपिया
bahrupiya	बहरूपिय	बहरूपिया
bahamaas	बहमास	बहामास
bahamas	बहमस	बहामास
bahaav	बहाव	बहाव
bahav	बहव	बहाव
bhav	भाव	बहाव
bahavalpur	बहावलपुर	बहावलपुर
bahawalpur	बहावलपुर	बहावलपुर
bahuchara	बहुचारा	बहुचरा
banthia	बंथिया	बांठिया
banthiya	बंठिया	बांठिया
bandhate	बंधाते	बांधते
bandhte	बंधते	बांधते
banbi	बनबी	बांबी
bombi	बोमबी	बांबी
bounceron	बाउंसरों	बाउंसरों
bowling	बोलिंग	बाउलिंग
baku	बकु	बाकू
bakuu	बकु	बाकू
baag	बाग	बाग
bag	बाग	बाग
bagh	बाघ	बाग
bagabani	बगाबनी	बागबानी
bagbani	बगबानी	बागबानी
bagali	बगली	बागली
bagli	बगली	बागली
baagiyon	बागियों	बागियों
bagiyon	बगियों	बागियों
baago	बागो	बागो
bago	बगगो	बागो
baji	बजी	बाज़ी
bazi	बाजी	बाज़ी
bajaru	बजारू	बाजारू
bazaru	बाजरू	बाजारू
bajuon	बजूूं	बाजुओं
badh	बढ़	बाध
badha	बढ़ा	बाधा
baadhaaon	बाधाओं	बाधाओं
baadhaon	बाधाओं	बाधाओं
badhaaon	बढ़ाओं	बाधाओं
badhaon	बढ़ाओं	बाधाओं
baadhit	बाधित	बाधित
badhit	बढ़ित	बाधित
baani	बानी	बानी
bani	बनी	बानी
baapa	बापा	बापा
baapaa	बापा	बापा
bapa	बापा	बापा
bapaa	बपा	बापा
baabat	बाबत	बाबत
babat	बबत	बाबत
babt	बब्ट	बाबत
bayern	बेयरन	बायर्न
byrun	ब्यून	बायर्न
barah	बरह	बारह
baarahamaasee	बारहमासी	बारहमासी
barahamasi	बरहमासी	बारहमासी
barahmasi	बरहमासी	बारहमासी
barahsinga	बाराशिंगा	बारहसिंगा
barasingha	बरासिंघा	बारहसिंगा
bala	बाला	बाला
baalti	बालती	बाल्टी
balti	बलती	बाल्टी
balty	बाल्टी	बाल्टी
baldvin	बल्दवीं	बाल्डविन
baldwin	बाल्ववीन	बाल्डविन
bavaji	बवाजी	बावजी
bavji	बवजी	बावजी
baawaraa	बावारा	बावरा
bavra	बवरा	बावरा
bawara	बवारा	बावरा
baahulya	बाहुल्य	बाहुल्य
bahuly	बहुल्य	बाहुल्य
bahulya	बहुल्य	बाहुल्य
box	बॉक्स	बाॅक्स
bikherati	बिखेरती	बिखेरती
bikherti	बिखेत्ती	बिखेरती
biggest	बाग्सेट	बिगेस्ट
bichhua	बिछुआ	बिछुआ
bichhuaa	बिछुआ	बिछुआ
biji	बीजी	बिजी
busy	बससी	बिजी
buzy	बुज्य	बिजी
bipin	बीपिन	बिपिन
bilae	बिलाए	बिलाई
bilai	बिलाई	बिलाई
billa	बिल्ला	बिल्ला
billaa	बिल्ला	बिल्ला
bilhaur	बिलहहर	बिल्हौर
bisva	बिस्व	बिस्वा
biswa	बिस्वा	बिस्वा
bag	बाग	बीएजी
bikaner	बिकनेर	बीकानेर
bikaneri	बिकनेरी	बीकानेरी
bk	बीकेी	बीके
beejak	बीजक	बीजक
bijak	बिजक	बीजक
beef	बीफ	बीफ
beem	बीम	बीम
bim	बीम	बीम
beemon	बीमों	बीमों
bimon	बीमोन	बीमों
beerganj	बीरगंज	बीरगंज
birganj	बीर्गंज	बीरगंज
beesavaan	बीसवां	बीसवां
bisavan	बिसवां	बीसवां
bisawan	बिसवान	बीसवां
beast	बेस्ट	बीस्ट
budvig	बुद्विग	बुडविग
budwig	बुद्विग	बुडविग
bull	बुल	बुल
bulaao	बुलाओ	बुलाओ
bulao	बुलाओ	बुलाओ
bule	बुले	बुले
bulletin	बुल्लीटन	बुलेटिन
brijesh	बृजेश	बृजेश
benvar	बेनवर	बेंवर
benwar	बेनवर	बेंवर
beaulad	बेलौड	बेऔलाद
bekaaboo	बेकाू	बेकाबू
bekabu	बेकबू	बेकाबू
bechakar	बेचकर	बेचकर
bechkar	बेचकर	बेचकर
bechate	बेचते	बेचते
bechte	बेचते	बेचते
bediyan	बेडियां	बेड़ियां
bethanal	बेथनाल	बेथनल
bethnal	बेथनाल	बेथनल
benis	बेनिस	बेनिस
belacha	बेलचा	बेलचा
belcha	बेलचा	बेलचा
belinda	बेलिंदा	बेलिंडा
bevkufana	बेवकुफना	बेवकूफाना
bewakoofaanaa	बेवकूफाना	बेवकूफाना
bewkufana	बेवकुनाना	बेवकूफाना
besahaaraa	बेशारा	बेसहारा
besahara	बेशारा	बेसहारा
basin	बासीन	बेसिन
besin	बेसिन	बेसिन
basil	बसील	बेसिल
besil	बेसिल	बेसिल
bandage	बंदाज	बैंडेज
bandej	बंदेज	बैंडेज
baithantey	बैठनते	बैठते
baithate	बैठते	बैठते
baitool	बैटूल	बैतूल
baitul	बैटुल	बैतूल
betul	बेटुल	बैतूल
baini	बैनी	बैनी
beni	बेनी	बैनी
bairakpur	बैरकपुर	बैरकपुर
barrackpore	बररककपोर	बैरकपुर
baila	बैला	बैला
bella	बेला	बैला
ballistic	बालिस्टिक	बैलिस्टिक
bells	बेल्स	बैल्स
bostan	बोस्तन	बॉस्टन
bosten	बोस्टेन	बॉस्टन
boston	बोस्टन	बॉस्टन
bokaro	बोकरो	बोकारो
bodara	बोडरा	बोदरा
bodra	बोद्र	बोदरा
bodraa	बोदरा	बोदरा
bona	बोना	बोना
borkar	बोरकर	बोरकर
borivali	बोरिवाली	बोरीवली
boriwali	बोरिवाली	बोरीवली
born	बोर्न	बोर्न
bolane	बोलने	बोलने
boliae	बोलिय	बोलिए
boliy	बोलीय	बोलिए
boliye	बोली	बोलिए
bosaan	बोसान	बोसान
bosan	बोसन	बोसान
bauni	बौनी	बौनी
bouni	बौनी	बौनी
byaawa	ब्यावा	ब्यावर
byavar	ब्यवर	ब्यावर
brajesh	ब्रेजश	ब्रजेश
brijesh	बृजेश	ब्रजेश
brahmalin	ब्रह्मालीन	ब्रह्मलीन
brahmleen	ब्रह्मलीन	ब्रह्मलीन
brahmlin	ब्रह्मलीन	ब्रह्मलीन
bravo	ब्रावो	ब्रावो
brigatn	ब्रिटनन	ब्रिगटन
brighton	ब्रिटों	ब्रिगटन
brigton	ब्रिट्न	ब्रिगटन
brigadier	ब्राइडीयर	ब्रिगेडियर
britain	ब्राइन	ब्रिटेन
breed	ब्रीड	ब्रीद
brock	ब्रॉक	ब्रोक
brok	ब्रोक	ब्रोक
broke	ब्रोक	ब्रोक
brocken	ब्रॉकन	ब्रोकन
broken	ब्रोकन	ब्रोकन
blosam	ब्लोसम	ब्लॉसम
blossom	ब्लॉसोम	ब्लॉसम
bhagaane	भगाने	भगाने
bhagane	भगने	भगाने
bhadakaaya	भड़काया	भड़काया
bhadakaya	भड़काया	भड़काया
bhadkaayaa	भड़काया	भड़काया
bhadkaya	भड़काया	भड़काया
bharakaaya	भरकाया	भड़काया
bharakaya	भरकाया	भड़काया
bhabhoot	भभूत	भभूत
bhabhut	भभूत	भभूत
bhay	भय	भय
bhaya	भया	भय
bhayo	भयो	भयो
bharatanatyam	भारतनत्यम	भरतनाट्यम्
bharatnatyam	भारतनत्यम	भरतनाट्यम्
bhartnatyam	भार्तनात्यम	भरतनाट्यम्
bharate	भरते	भरते
bharte	भरते	भरते
bharani	भारणी	भरनी
bharni	भारी	भरनी
bharane	भरने	भरने
bharne	भरने	भरने
bhara	भारा	भरा
bhavishya	भविष्य	भविष्य
bhaate	भाते	भाते
bhate	भटे	भाते
bhanu	भानू	भानू
bhabar	भबर	भाबर
bhareeye	भरीय	भारीय
bhariy	भारीय	भारीय
bhavanaon	भवानाओं	भावनाओं
bhavnaon	भवनाओं	भावनाओं
bhaskar	भास्कर	भास्कर
bheed	भीड़	भीड़
bheera	भीरा	भीरा
bhira	भीरा	भीरा
bheesham	भीशम	भीष्म
bhisham	भिशम	भीष्म
bhishm	भिश्म	भीष्म
bhugat	भुगत	भुगत
bhugata	भुगता	भुगता
bhugta	भूगता	भुगता
bhutto	भूत्तो	भुट्टो
bhumi	भूमि	भुमि
bhurbhura	भूरभूरा	भुरभुरा
bhookh	भूख	भूख
bhukh	भूख	भूख
bhookhi	भूखी	भूखी
bhukhi	भूखी	भूखी
bhoogol	भूगोल	भूगोल
bhugol	भूगोल	भूगोल
bhootal	भूतल	भूतल
bhutal	भूताल	भूतल
bhoopsingh	भूपसिंघ	भूपसिंह
bhupsingh	भूपसिंघ	भूपसिंह
bhumi	भूमि	भूमी
bhumika	भूमिका	भूमी
bhulata	भूलता	भूलता
bhulataa	भुलता	भूलता
bhulta	भूलता	भूलता
bhula	भूला	भूला
bhulaa	भुला	भूला
bhooli	भूली	भूली
bhuli	भूली	भूली
bhulo	भूलो	भूलो
bhulon	भूलों	भूलों
bhusi	भूसी	भूसी
bhooswaami	भूस्वामी	भूस्वामी
bhusvami	भूस्वामी	भूस्वामी
bhuswami	भूस्वामी	भूस्वामी
bhengapan	भेंगपन	भेंगापन
bhairavnath	भैरववाथथथ	भैरवनाथ
bhairo	भैरो	भैरो
bhogatey	भोगते	भोगते
bhogte	भोगते	भोगते
bhola	भोला	भोला
bholi	भोली	भोली
bholu	भोलू	भोलू
bhaunho	भौन्हो	भौंहों
bhaunhon	भौनहों	भौंहों
bhoonhon	भूनहों	भौंहों
bhraant	भ्रांत	भ्रांत
bhrant	भ्रंत	भ्रांत
brant	ब्रांट	भ्रांत
bhraanti	भ्रांती	भ्रांति
bhranti	भ्रंती	भ्रांति
branti	ब्रांती	भ्रांति
bhraantiyan	भ्रांतियां	भ्रांतियां
bhrantiyan	भ्रांतियां	भ्रांतियां
bhraantiyon	भ्रांतियों	भ्रांतियों
bhrantiyon	भ्रंतियों	भ्रांतियों
mangesh	मंगेश	मंगेश
manch	मांच	मंच
manchit	मंचित	मंचित
mancheeye	मंचीय	मंचीय
manchiy	मंचीय	मंचीय
manchiya	मंचिया	मंचीय
manchon	मांचों	मंचों
manjil	मंजील	मंजिल
manzil	मंजील	मंजिल
manjila	मंजीला	मंजिला
manzila	मंजीला	मंजिला
manjilein	मंजीलें	मंजिलें
manjilen	मंजीलें	मंजिलें
manzilein	मंजीलें	मंजिलें
manto	मंटो	मंटो
mantriyon	मंत्रियों	मंत्रियों
makrani	मकरानी	मकरानी
maksad	मकसद	मक्सद
makhdumpur	मखदुमपुर	मखदुमपुर
machaaye	मचाए	मचाए
machae	मचाए	मचाए
machaye	मचाए	मचाए
machaanon	मचानों	मचानों
machanno	मचनननोंों	मचानों
machano	मचनों	मचानों
machanon	मचानों	मचानों
madaura	माौौरा	मढ़ौरा
madhuara	मधुआरा	मढ़ौरा
madhura	माधुरा	मढ़ौरा
manipal	मनीपाल	मणिपाल
matpatron	मतपत्रों	मतपत्रों
matthe	मत्ठे	मत्थे
matsyavatar	मत्स्यवतार	मत्स्यावतार
matsyavtar	मत्स्यवत्र	मत्स्यावतार
masyendranath	मस्येंद्रनाथ	मत्स्येंद्रनाथ
matsyendranath	मत्सींद्रनाथ	मत्स्येंद्रनाथ
madhupur	मधुपुर	मधुपुर
manmarji	माममाज्ी	मनमर्जी
manae	मनाए	मनाए
manaye	मनाय	मनाए
mnaey	मनाए	मनाए
mam	माम	मम
mum	मम	मम
maryokar	मार्योकार	मयोर्का
mayorka	मयोरका	मयोर्का
mayorkaa	मयोरका	मयोर्का
mardaani	मरदानी	मरदानी
mardani	मारदानी	मरदानी
marmar	मरमर	मरमर
murmur	मुरमूर	मरमर
maratha	मारथा	मराठा
marathi	मारीी	मराठी
marji	मारजी	मर्जी
mardanagi	मरदानगी	मर्दानगी
mardangi	मारदंगी	मर्दानगी
mardo	मार्डो	मर्दों
mardon	मार्डों	मर्दों
maryaadaa	मर्यादा	मर्यादा
maryada	मार्यादा	मर्यादा
maryaadaaon	मर्यादाओं	मर्यादाओं
maryadaon	मार्यादाओं	मर्यादाओं
malaga	माला	मलागा
malaar	मलार	मलार
malar	मालर	मलार
mashrak	मशर्क	मशरक
masaaledaar	मसालेदार	मसालेदार
masaledaar	मसलेदार	मसालेदार
masaledar	मसलेदार	मसालेदार
masoor	मसूर	मसूर
masur	मसूर	मसूर
masse	मससे	मस्से
mahakane	महकाने	महकने
mahakne	महकने	महकने
mahkane	महकाने	महकने
mehkane	मेकने	महकने
mahalon	महालों	महलों
mahlon	महलों	महलों
mahagranth	महाग्रंथथथथठठ	महाग्रंथ
mhagranth	महाग्रंथथथथठठ	महाग्रंथ
mahajan	महजन	महाजन
mhajan	महान	महाजन
mahathir	महतीर	महाथिर
mhathir	महहतिर	महाथिर
mahanatam	महनतम	महानतम
mahantam	महानतम	महानतम
mhantam	महांतम	महानतम
mahanideshak	महानिदेशक	महानिदेशक
mahanirdeshak	महानिर्देशक	महानिदेशक
mhanideshak	महानिदेशक	महानिदेशक
mahapauron	महापौरों	महापौरों
mhapauron	महापौरों	महापौरों
mahapran	महाप्रण	महाप्राण
mhapran	महाप्रण	महाप्राण
mahamantr	महामंत्र	महामंत्र
mahamantra	महामंत्र	महामंत्र
mhamantra	महामंत्र	महामंत्र
maharaja	महााजा	महाराजा
mahavigyan	महाविज्ञान	महाविज्ञान
mhavidyan	महाविद्ञान	महाविज्ञान
mahavidya	महाविद्य	महाविद्या
mhavidya	महाविद्य	महाविद्या
mahavishnu	महाविशनु	महाविष्णु
mahasingh	महासिंह	महासिंह
mahasinh	महासिंह	महासिंह
mahipal	महीपाल	महिपाल
mahin	महीं	महीन
mahinon	महिनों	महीनों
maang	मांग	मांग
mang	मंग	मांग
mangani	मंगनी	मांगनी
mangni	मंगनी	मांगनी
maanga	मांगा	मांगा
manga	मंगा	मांगा
maangi	मांगी	मांगी
mangi	मंगी	मांगी
maange	मांगे	मांगे
mange	मांगे	मांगे
mango	मंगो	मांगो
maori	मारी	माओरी
maajin	माजीन	माजिन
majin	मजीन	माजिन
mathe	माठे	माथे
mathey	माथे	माथे
maap	माप	माप
map	मैप	माप
mop	मॉप	माप
mamooli	ममूली	मामूली
mamuli	ममुली	मामूली
mame	मे	मामे
maarvaad	मारवाद	मारवाड़
marvad	मारवाद	मारवाड़
marwar	मारवार	मारवाड़
maariya	मारिया	मारिया
mariya	मारिया	मारिया
maariyo	मारियो	मारियो
mario	मारियो	मारियो
mariyo	मारियो	मारियो
martha	मार्था	मार्था
maalish	मालीश	मालिश
malish	मालीश	मालिश
mave	मेव	मावे
mavey	मेव	मावे
maas	मास	मास
mas	मास	मास
mass	मैस	मास
maason	मासों	मासों
mason	मासों	मासों
mitaao	मिटाओ	मिटाओ
mitao	मिटाओ	मिटाओ
mithaai	मिठाई	मिठाई
mithai	मिथाई	मिठाई
media	मेडिया	मिडिया
mithila	मिथिला	मिथिला
mithilanchal	मिथिलांचल	मिथिलांचल
mithya	मिथ्य	मिथ्या
mimicry	माइमिक्री	मिमिक्री
milkiyat	मिल्कियत	मिल्कियत
misha	मिशा	मिशा
mungeri	मुंगरी	मुंगेरी
mundva	मुंडवा	मुंडवा
mundwa	मुंडवा	मुंडवा
munshiganj	मुंशीगंज	मुंशीगंज
mukarte	मुकर्ते	मुकरते
mukartey	मुकर्ते	मुकरते
mukhopadhyaya	मुखोपाध्या	मुखोपाध्याय
mukhyopadhyaay	मुख्योपाध्याय	मुखोपाध्याय
mukhyamantri	मुख्यमंत्री	मुख्यमंत्री
munaf	मुनाफ	मुनाफ
munafa	मुनाफा	मुनाफा
munnu	मुन्नू	मुन्नू
mufalisi	मुफलीसी	मुफलिसी
muflisi	मुफ्लीसी	मुफलिसी
mubarakpur	मुबररकपुर	मुबारकपुर
mubarkpur	मुबर्कपुर	मुबारकपुर
murjha	मुरझा	मुर्झा
multae	मुल्ताई	मुल्ताई
multai	मुल्ताई	मुल्ताई
mushahid	मुशाहिद	मुशाहिद
muhavare	मुहावे	मुहावरे
muhavre	मुहावे	मुहावरे
mooth	मूथ	मूठ
muth	मूठ	मूठ
mood	मूद	मूड
mud	मुद	मूड
moodi	मूदी	मूडी
moody	मूड्	मूडी
mool	मूल	मूल
mul	मूल	मूल
moolchand	मूल्चंद	मूलचंद
mulchand	मूल्चंद	मूलचंद
moolar	मूलर	मूलर
mular	मूलर	मूलर
muller	मूल्लर	मूलर
moolon	मूलों	मूलों
mulon	मूलों	मूलों
maxico	मैक्सिको	मेक्सिको
mexico	मैक्सिको	मेक्सिको
mega	मेगा	मेगा
megapixal	मेगेपिक्ल	मेगापिक्सल
megapixel	मैगेपिक्स	मेगापिक्सल
mejbaan	मेजबान	मेजबान
mejban	मेजबन	मेजबान
mezbaan	मेजबान	मेजबान
mejabani	मेजबनी	मेजबानी
mejbaani	मेजबानी	मेजबानी
mejbani	मेजबननी	मेजबानी
mezabani	मेजाबनी	मेजबानी
mejbaan	मेजबान	मेज़बान
mejban	मेजबन	मेज़बान
mezbaan	मेजबान	मेज़बान
mejbaani	मेजबानी	मेज़बानी
mejbani	मेजबननी	मेज़बानी
mezbaani	मेजबानी	मेज़बानी
mate	मेट	मेट
met	मेट	मेट
mates	मेट्स	मेट्स
medical	मेडिकल	मेडीकल
methanol	मेथनोल	मेथेनॉल
menu	मेनू	मेनू
mem	मेम	मेम
melaghaat	मेलााट	मेलघाट
melghat	मेल्घट	मेलघाट
melaanin	मेलानीन	मेलानिन
melanin	मेलनीन	मेलानिन
melaani	मेलानी	मेलानी
melani	मेलनी	मेलानी
maheman	महेमन	मेहमान
mehamaan	मेहमान	मेहमान
mehaman	मेहमन	मेहमान
mehmaan	मेहमान	मेहमान
mehman	मेहमन	मेहमान
meharaam	मेहराम	मेहराम
mehram	मेहाम	मेहराम
macbook	मैकबूक	मैकबुक
matix	मैटिक्स	मैट्रिक्स
matrix	मैट्रिक्स	मैट्रिक्स
mad	माद	मैड
made	मेड	मैड
maid	मैड	मैड
maddy	मैड्	मैडी
maidi	मैडी	मैडी
main	मैन	मैन
man	मान	मैन
men	मेन	मैन
mainan	मैनन	मैनन
menon	मेनों	मैनन
manner	मननन	मैनर
maina	मैना	मैना
maine	मैने	मैने
marrej	मारज	मैरेज
marriage	मारिज	मैरेज
merraige	मेरेज	मैरेज
maisachusets	मैसेच्सेट्स	मैसाचुसेट्स
massachusetts	मैसेचुस्टेट्स	मैसाचुसेट्स
maisor	मैसर	मैसोर
maisore	मैसोर	मैसोर
mysore	मासोर	मैसोर
mod	मोड़	मॉड
mode	मोड़	मॉड
modern	मॉडर्न	मॉडर्न
module	मोड़ल	मॉड्यूल
modules	मॉडल्स	मॉड्यूल्स
modyuls	मॉड्यूल्स	मॉड्यूल्स
mauritious	मॉरिशसससस	मॉरिशस
mauritius	मॉरियसयससस	मॉरिशस
mogali	मोगली	मोगली
mowgli	मौजली	मोगली
motive	मोटिव	मोटिव
mol	मॉल	मोल
mold	मॉल्ड	मोल्ड
moshe	मोशे	मोशे
mosad	मोसद	मोसाद
mohana	मोहना	मोहाना
mohani	मोहनी	मोहानी
mohini	मोहिनी	मोहिनी
mohim	मोहिम	मोहिम
maukon	मौकों	मौकों
mauma	मौमा	मौमा
maurya	मौर्य	मौर्या
morya	मोर्या	मौर्या
maurya	मौर्य	मौर्यों
mauryon	मौर्यों	मौर्यों
moryon	मॉर्यों	मौर्यों
maulaviyon	मौलवियों	मौलवियों
maulvidon	मौलविदों	मौलवियों
maulviyon	मौलवियों	मौलवियों
maule	मौले	मौले
mauley	मौले	मौले
mausa	मौसा	मौसा
yatn	यतन	यत्न
yatna	यतना	यत्न
yada	यादा	यदा
yda	यादा	यदा
yaduvansh	यादुवंश	यदुवंश
yaduwansh	यादुवंश	यदुवंश
jerusalem	जर्सूलेम	यरूशलेम
yarooshaleim	यारूशालेम	यरूशलेम
yarushalem	यारुशलेम	यरूशलेम
yashpaal	यशपाल	यशपाल
yashpal	यशपाल	यशपाल
yaatna	यातना	यातना
yatna	यतना	यातना
yaatanaon	यातनाओं	यातनाओं
yatnaon	यतनाओं	यातनाओं
yarayan	यायान	यात्राएं
yatraein	यतराएं	यात्राएं
yatraen	यतराएं	यात्राएं
yaariyan	यारियां	यारियां
yariyan	यारियां	यारियां
yaari	यारी	यारी
yari	यारी	यारी
yugam	युगम	युग्म
yugm	युग्म	युग्म
yuddhrat	युद्धारत	युद्धरत
yudhrat	युद्धात	युद्धरत
ukrainian	उक्रेनियन	यूक्रेनियन
ukranian	उक्रानियन	यूक्रेनियन
jerusalem	जर्सूलेम	येरुशलम
yorker	योर्कर	यॉर्कर
yojanaein	योजनाएं	योजनाएं
yojanaen	योजनाएं	योजनाएं
yojanaye	योजनाए	योजनाएं
rangate	रंगते	रंगते
rangte	रंगते	रंगते
rangkata	रंगकता	रंजकता
ranjkatha	रणजकाठा	रंजकता
ranjkta	रणजकता	रंजकता
raees	रेज	रईस
rais	रेस	रईस
raktaabh	रक्ताभ	रक्ताभ
raktabh	रक्तभ	रक्ताभ
rakhna	रखना	रखना
raghupati	रघुपति	रघुपति
raghuram	रघुराम	रघुराम
registerd	रेजिस्ट्ड	रजिस्टर्ड
registered	रेजिस्टरड	रजिस्टर्ड
ratanpur	रतनपुर	रतनपुर
runners	रननर्स	रनर्स
rayan	रायन	रयान
ryan	र्यान	रयान
ralhan	राल्न	रल्हन
ravish	रविषष	रविश
ravael	रवाएल	रवैल
ravel	रवेल	रवैल
rawail	रवैल	रवैल
rasad	रसद	रसद
rasaayanik	राायनिक	रसायनिक
rasaayanika	राायनिका	रसायनिक
rasayanika	राायनिका	रसायनिक
rasyanik	रास्यानिक	रसायनिक
rasaayanon	रसायनोंं	रसायनों
rasayanon	रसायनों	रसायनों
rahamat	रहमत	रहमत
rahmat	रहमत	रहमत
rhamat	रहमत	रहमत
rahenge	राहेंगे	रहेंगे
rahegi	रहेगी	रहेगी
rounder	राउंडर	राउंडर
raak	राक	राक
rak	रक	राक
raakhe	राखे	राखे
rakhe	रखे	राखे
raagon	रागों	रागों
ragon	रगों	रागों
raghavan	रघावन	राघवन
raaj	राज	राज
raj	राज	राज
rajkot	राजकोट	राजकोट
rajtantra	राजतंत्र	राजतंत्र
raajneetikaran	राजनीतिकरण	राजनीतीकरण
rajneetikaran	राजनीतिकरण	राजनीतीकरण
rajnitikaran	राजनीतिकरण	राजनीतीकरण
rajma	राजमा	राजमां
rajman	राजमान	राजमां
raajasva	राजस्व	राजस्व
rajasva	राजस्व	राजस्व
raaji	राजी	राजी
raji	राजी	राजी
rajinaama	राजिनामा	राजीनामा
rajinama	राजिनामा	राजीनामा
raajon	राजों	राजों
rajon	राजों	राजों
rana	राना	राणा
raatrichar	रात्रीचार	रात्रिचर
ratrichar	रत्रिचार	रात्रिचर
raadhe	राधे	राधे
radhe	राधे	राधे
ranapur	रणापुर	रानापुर
rabin	रबीन	राबिन
robin	रोबीन	राबिन
rabha	रभा	राभा
ramkot	रामकोट	रामकोट
ramkote	रामकोट	रामकोट
ramtek	रामतेक	रामटेक
rampur	रामपुर	रामपुर
rambharose	रामभारस	रामभरोसे
rambharosey	रामभरोसी	रामभरोसे
ramraj	रामराज	रामराज
raalod	रालो	रालोद
ralaud	राौौ	रालोद
ralod	रालोड	रालोद
ravaley	रवाले	रावले
ravle	रवले	रावले
rasayanik	राायनिक	रासायनिक
racreation	रैक्रेशनन	रिक्रिएशन
recreation	रिक्रेयनशन	रिक्रिएशन
rig	राग	रिग
riggs	राग्सस	रिग्स
rigs	राग्स	रिग्स
richual	रिचुएल	रिचुअल
ritual	रियुआल	रिचुअल
reduction	रेडक्शन	रिडक्शन
ripan	रिपन	रिपन
ripon	रिपों	रिपन
ria	राय	रिया
riya	रिया	रिया
rishte	रिश्टे	रिश्ते
rishtey	रिश्टे	रिश्ते
risane	रिसने	रिसने
risaney	रिसने	रिसने
risne	रिसने	रिसने
rihana	रिहना	रिहाना
rihanna	रिहनना	रिहाना
regal	रेगल	रीगल
rigal	रिगल	रीगल
reasonal	रिजोनल	रीजनल
regional	रेजियनल	रीजनल
retreate	रिट्रेट	रीट्वीट
retweet	रेतवीत	रीट्वीट
reeta	रीता	रीता
rita	रीता	रीता
rukate	रुकते	रुकते
rukte	रुक्ते	रुकते
ruktey	रुक्ते	रुकते
rugan	रुगन	रुग्ण
rugna	रुगना	रुग्ण
ruganta	रुगनता	रुग्णता
rugnata	रुगनाता	रुग्णता
rojvelt	रोजवेल्ट	रुजवेल्ट
roojwelt	रूजवेल्ट	रुजवेल्ट
roosevelt	रूसेवल्ट	रुजवेल्ट
rodolph	रोडोल्फ	रुडोल्फ
rudolf	रूडोल्फ	रुडोल्फ
rudolph	रूदोल्फ	रुडोल्फ
roopesh	रूपेश	रुपेश
rupesh	रूपेश	रुपेश
ruby	रबबी	रुबी
roomani	रूमानी	रुमानी
rumani	रुमानी	रुमानी
rukavaton	रुकावटों	रूकावटों
root	रूत	रूट
route	राउट	रूट
rooting	रूटिंगग	रूटिंग
routine	राउटिइन	रूटिंग
routing	राउटिंग	रूटिंग
roots	रूट्सस	रूट्स
routes	रॉट्सस	रूट्स
roopak	रूपक	रूपक
rupak	रूपक	रूपक
roopi	रूपी	रूपी
rupi	रूपी	रूपी
rantle	रंतल	रेंटल
rental	रेंटल	रेंटल
registan	रेजिस्तान	रेगिस्तान
registani	रेजिस्तानी	रेगिस्तानी
reja	रेजा	रेजा
reza	रेजा	रेजा
rate	रतते	रेट
rate	रतते	रेत
ret	रेट	रेत
refaeli	रेफाइली	रेफेली
refeli	रेफेली	रेफेली
reshe	रेशे	रेशे
reshey	रेशे	रेशे
race	रेस	रेस
rese	रेसे	रेस
racer	रेसर	रेसर
recer	रिसर	रेसर
racing	रेसिंग	रेसिंग
reson	रेसों	रेसों
rehaana	रहाना	रेहाना
rehana	रहना	रेहाना
racketeer	रैकेटीर	रैकेटियर
racketier	रैकेटर	रैकेटियर
rectare	रिक्टेर	रैकेटियर
radical	रेडिकल	रैडिकल
raidical	रेडिकल	रैडिकल
raith	राठ	रैथ
rapping	रेपिंग	रैपिंग
wrapping	वार्पिंग	रैपिंग
robertsan	रोबर्ट्सन	रॉबर्टसन
robertson	रोबर्ट्सनननन	रॉबर्टसन
robinson	रॉबिंसन	रॉबिंसन
royals	रॉयल्स	रॉयल्स
rojlin	रोजलिन	रोजलिन
rozlyn	रोजलीन	रोजलिन
rotation	रोटेशन	रोटेशन
rodrigo	रोडरिगो	रोड्रिगो
ronaldo	रोनाल्डो	रोनाल्डो
ronit	रोनिट	रोनित
roni	रोनी	रोनी
ropane	रोपने	रोपने
ropaney	रोपने	रोपने
ropne	रोपने	रोपने
robin	रोबीन	रोबिन
roya	रोया	रोया
rollers	रॉलर्स	रोलर्स
rovan	रोवन	रोवन
rowan	रोवन	रोवन
rosario	रोसरियो	रोसारियो
rosariyo	रोसरियो	रोसारियो
raubadaar	रौबादार	रौबदार
raubadar	रौबादार	रौबदार
raubdar	रौबदार	रौबदार
landara	लंडरा	लंगड़ा
langada	लंगड़ा	लंगड़ा
langda	लंगड़ा	लंगड़ा
langar	लंगर	लंगर
langaron	लंगारों	लंगरों
langron	लांग्रों	लंगरों
lambi	लांबी	लंबी
lakeer	लेकर	लकीर
lakir	लाकिर	लकीर
lakiron	लाकिरों	लकीरों
lakme	लक्मे	लक्मे
lakshmidhar	लक्ष्मीधार	लक्ष्मीधर
lakshmighar	लक्ष्मीघर	लक्ष्मीधर
lakshy	लक्ष्य	लक्ष्य
lakshya	लक्ष्य	लक्ष्य
lakshyon	लक्ष्यों	लक्ष्यों
lux	लक्स	लक्स
laksar	लकसर	लक्सर
luxor	लक्सर	लक्सर
lakhkhi	लखखखी	लख्खी
lagna	लगना	लगना
laganewale	लगनेवाले	लगनेवाले
lagnevaaley	लगनेवाले	लगनेवाले
lagnewale	लगनेवाले	लगनेवाले
lagega	लगेगा	लगेगा
lajjalu	लज्जललू	लज्जालु
latkate	लटकते	लटकाते
ladki	लड़की	लड़की
ladate	लड़ते	लड़ते
ladte	लड़ते	लड़ते
ladaai	लड़ाई	लड़ाई
ladai	लड़ाई	लड़ाई
ladaaiyon	लड़ाइयों	लड़ाईयों
ladaeyon	लड़ाइयों	लड़ाईयों
ladaiyon	लड़ाइयों	लड़ाईयों
lapetane	लेपेटने	लपेटने
lapetne	लेपटने	लपेटने
labada	लबाड़ा	लबादा
lbada	लबड़ा	लबादा
labdh	लब्ध	लब्ध
lbdh	लब्ी	लब्ध
lalak	लाक	ललक
lalkarata	लाकराता	ललकारता
lalkarta	लाकर्ता	ललकारता
lalla	लाला	लल्ला
lavasa	लवासा	लवासा
lovasa	लोवासा	लवासा
lassi	लासी	लस्सी
lahanaa	लहना	लहना
lahna	लहना	लहना
lehna	लहना	लहना
lahraee	लहराई	लहराई
lahrai	लहराई	लहराई
lehrayi	लहराई	लहराई
lahalhati	लहलहती	लहलहाती
lahlahaati	लहलहती	लहलहाती
lahlahati	लहलहती	लहलहाती
lahsun	लहसून	लहसुन
lasoon	लासून	लहसुन
lanchar	लंचार	लांचर
launcher	लॉनचर	लांचर
lycopene	लाइकॉपनन	लाइकोपिन
lime	लाइम	लाइम
lives	लिव्स	लाइव्स
live	लाइव	लाईव
laegi	लाएगी	लाएगी
lagataar	लगातार	लागातार
lagatar	लगातर	लागातार
laata	लाटा	लाता
lata	लटा	लाता
laati	लाती	लाती
lati	लाती	लाती
layega	लायगा	लायेगा
lalpur	लालपुर	लालपुर
las	लास	लास्ट
last	लास्त	लास्ट
lindbhed	लिंडबेड	लिंगभेद
lingbhed	लिंगभेड	लिंगभेद
lindan	लिंडन	लिंडन
lindn	लिंडन	लिंडन
lindon	लिंडों	लिंडन
likhakar	लिखककर	लिखकर
likhkar	लिखकर	लिखकर
ligar	लिगर	लिगर
liger	लाइर	लिगर
liberation	लाइब्रेशन	लिबरेशन
libration	लाइब्रेशन	लिबरेशन
liberation	लाइब्रेशन	लिब्रेशन
libration	लाइब्रेशन	लिब्रेशन
leaderon	लेडरों	लीडरों
leedaron	लीडारों	लीडरों
lidaron	लिडारों	लीडरों
liidaron	लिइडरों	लीडरों
louis	लॉयसज	लुईस
luis	लिस	लुईस
ludhakate	लुढ़कते	लुढ़कते
ludhkate	लुढ़कते	लुढ़कते
lurhakate	लुरखकते	लुढ़कते
lutf	लुट	लुत्फ
lumding	लुमडिंग	लुमडिंग
lootmaar	लूटमार	लूटमार
lootmar	लूटमार	लूटमार
landal	लंडल	लेंडल
lendal	लेंडल	लेंडल
lega	लेगा	लेगा
legaa	लेगा	लेगा
letakar	लेटकर	लेटकर
letkar	लेटकर	लेटकर
lenevali	लेनेवाली	लेनेवाली
lenewali	लेनेवाली	लेनेवाली
label	लेबल	लेबल
labeling	लेबलिंग	लेबलिंग
labelling	लेबललिंग	लेबलिंग
labelo	लेबलो	लेबलों
labelon	लेबलों	लेबलों
lebalon	लेबलों	लेबलों
lemon	लेमोन	लेमन
laingadan	लैंगड़न	लैंगडन
langdon	लांगडों	लैंगडन
lengdan	लेंगड़न	लैंगडन
laigikata	लैगिकता	लैंगिकता
laingikta	लैंगिकता	लैंगिकता
lanset	लैंसेट	लैंसेट
lenset	लेंसेट	लैंसेट
lairi	लैरी	लैरी
lairy	लैरी	लैरी
larry	लारी	लैरी
lace	लेस	लैस
less	लेस	लैस
locket	लॉकेट	लॉकेट
laundry	लौनद्री	लॉन्ड्री
longewal	लोंगेवाल	लोंगोवाल
longewala	लोंगेवाला	लोंगोवाल
longoval	लोंगोवल	लोंगोवाल
log	लोग	लोग
loge	लोग	लोगे
lochdar	लोचदार	लोचदार
lodi	लोडी	लोदी
laurence	लॉरेंस	लौरेंस
laurens	लॉरेंस	लौरेंस
laurense	लॉरेंस	लौरेंस
wonder	वंडर	वंडर
vansh	वांश	वंश
vanshdhar	वंशधार	वंशधर
vanshavad	वंशावाद	वंशवाद
vanshvaad	वंशवाद	वंशवाद
vanshvad	वंशवाद	वंशवाद
wanshwad	वांशवाद	वंशवाद
vajood	वजूद	वजूद
vajud	वजुद	वजूद
wajood	वजूद	वजूद
vadali	वादली	वडाली
vadli	वाली	वडाली
wadali	वाली	वडाली
vanita	वनीता	वनिता
vareinye	वेरेनी	वरेण्य
varenya	वरेन्य	वरेण्य
varn	वर्न	वर्ण
varna	वर्ण	वर्ण
varnit	वर्नीत	वर्णित
vartamaan	वर्तमान	वर्तमान
vartaman	वर्तमान	वर्तमान
vartmaan	वर्तमान	वर्तमान
vartman	वर्तमन	वर्तमान
varddhaman	वर्द्धमन	वर्द्धमान
vardhmaan	वर्धमान	वर्द्धमान
vardhman	वर्धमान	वर्द्धमान
verbal	वेरबल	वर्बल
varshan	वर्षण	वर्शन
vasharan	वाषाण	वर्शन
vershan	वर्षण	वर्शन
version	वे्सियन	वर्शन
varsaache	वर्साचे	वर्साचे
varsaryache	वर्सर्यचे	वर्साचे
vasearche	वेसर्च	वर्साचे
valkan	वालकन	वल्कन
valkkan	वाक्कन	वल्कन
velkan	वेलकन	वल्कन
vash	वाश	वश
vashikaran	वाशीकरण	वशीकरण
vaangchuk	वांगचुक	वांगचुक
vangchuk	वंंचुक	वांगचुक
wangchuk	वंंचुक	वांगचुक
want	वांत	वांट
vije	विजे	वाइज
vise	विजे	वाइज
wise	वाइस	वाइज
vatar	वातर	वाटर
water	वेटर	वाटर
watson	वा्सन	वाटसन
wattson	वात्सों	वाटसन
vaan	वान	वाण
waan	वान	वाण
vaanon	वानों	वाणों
vanon	वानों	वाणों
wanon	वानों	वाणों
vatanukulan	वतनुुकुलन	वातानुकूलन
watanukoollan	वाननुकूल्लन	वातानुकूलन
vaadak	वादक	वादक
vadak	वादक	वादक
vaadiyon	वादियोंं	वादियों
vadiyon	वादियों	वादियों
wadiyon	वादियों	वादियों
vayana	वायना	वायना
vayna	वायना	वायना
wayna	वायना	वायना
wireless	वायरल्स	वायरलेस
wirerless	वायर्लेस	वायरलेस
warrior	वारियर	वारियर्स
warriors	वारियर्स	वारियर्स
valve	वालवे	वाल्व
wolv	वॉल्व	वाल्व
vastavik	वास्ताविक	वास्तविक
vastvik	वास्त्विक	वास्तविक
vaahikayen	वाहिकाएं	वाहिकाएं
vahikayen	वहहिकाएं	वाहिकाएं
wahikayan	वहहिकाएं	वाहिकाएं
winter	विंटर	विंटर
vincent	विंकेंट	विंसेंट
vikalpon	विकल्पों	विकल्पों
wicket	वाइकेट	विकेट
vikramjeet	विक्रमजीत	विक्रमजीत
vikramjit	विक्रमजित	विक्रमजीत
vichaarakon	विचारकों	विचारकों
vicharakon	विचारकों	विचारकों
vigyan	विज्ञान	विज्ञान
vigyaani	विज्ञानी	विज्ञानी
vigyani	विज्ञानी	विज्ञानी
vigyaanon	विज्ञानों	विज्ञानों
vigyanon	विज्ञानों	विज्ञानों
vitthal	वित्थल	विट्ठल
viththal	विथथल	विठ्ठल
vitthal	वित्थल	विठ्ठल
vitark	वितर्क	वितर्क
vidhaaein	विधाएं	विद्याएं
vidyaayein	विद्याएं	विद्याएं
vidyaen	विद्याएं	विद्याएं
vidhaaon	विधाओं	विद्याओं
vidyaaon	विद्याओं	विद्याओं
vidyaon	विद्याओं	विद्याओं
vidhansabhaein	विधानसभाएं	विधानसभाएं
vidhansabhaen	विधानसभाएं	विधानसभाएं
vidhivat	विधिवत	विधिवत
vidhut	विधुत	विधुत
vinasht	विनाष्ट	विनष्ट
vineet	विनीत	विनीत
vinit	विनीत	विनीत
vipreetataa	विप्रीतता	विपरीतता
vipritata	विप्रितता	विपरीतता
vipra	विप्र	विप्रा
vipro	विप्रो	विप्रो
wipro	विप्रो	विप्रो
vibha	विभा	विभा
vibhajak	विभाजक	विभाजक
vibhram	विभ्रम	विभ्रम
vibhrm	विभ्रम	विभ्रम
vibram	विब्राम	विभ्रम
vimarsh	विमार्श	विमर्श
vimarsho	विमार्शो	विमर्शों
vimarshon	विमार्शों	विमर्शों
virajati	विराजती	विराजती
virechan	विरेचन	विरेचन
virodh	विरोध	विरोध
virodhabhasi	विरोधाासी	विरोधाभासी
virodhabhason	विरोधाासों	विरोधाभासों
vividh	विविध	विविध
vivekahin	विवेकाहीन	विवेकहीन
vivekheen	विवेखीन	विवेकहीन
visheshan	विशेषण	विशेषण
visheshanon	विशेषणोंं	विशेषणों
visheshaadhikaar	विशेषाधिकार	विशेषाधिकार
visheshadhikar	विशेषधिकार	विशेषाधिकार
vishwasaniy	विश्वासनीय	विश्वसनीय
vishwasniiya	विश्वासनीय	विश्वसनीय
vishwasaniyata	विश्वासनीयता	विश्वसनीयता
vishwasniiyataa	विश्वस्नीयता	विश्वसनीयता
vishahin	विशाहीन	विषहीन
vishhin	विश्हीन	विषहीन
vishanu	विशानु	विष्णु
vishnu	विश्नु	विष्णु
vlc	व्एलसीीी	वीएलसी
weeks	वीक्स	वीक्स
veerchand	वीरचंद	वीरचंद
virchand	विरचंद	वीरचंद
veeresh	वीरेश	वीरेश
viresh	विरेश	वीरेश
vritton	वृत्तों	वृत्तों
vruton	वृतों	वृत्तों
vrutton	वृत्तों	वृत्तों
venkataraman	वेंकटरमण	वेंकटरमन
venkatraman	वेंकट्रमण	वेंकटरमन
ved	वेड	वेड
wade	वेड	वेड
wed	वेड	वेड
wedding	वेडिंग	वेडिंग
vediyon	वेदियों	वेदियों
vedon	वेडों	वेदों
venezuela	वेनेजेला	वेनेजुएला
veronica	वेरोनिका	वेरोनिका
veronika	वेरोनिका	वेरोनिका
weronika	वेरोनिका	वेरोनिका
velvet	वेलवेट	वेलवेट
welwet	वेलवेट	वेलवेट
welder	वेल्डर	वेल्डर
weldor	वेल्डर	वेल्डर
welding	वेल्डिंग	वेल्डिंग
wealth	वेल्थ	वेल्थ
vellur	वेल्र	वेल्लूर
velur	वेलूर	वेल्लूर
vesh	वेश	वेश
wasting	वास्टिंगगग	वेस्टिंग
westing	वेस्टिंग	वेस्टिंग
wastinghouse	वास्टिंघोस	वेस्टिंगहाउस
westinghouse	वेस्टिंगोस	वेस्टिंगहाउस
vaisley	वैसले	वेस्ले
vesle	वेस्ले	वेस्ले
wesle	वेस्ले	वेस्ले
vaigyaanik	वैज्ञानिक	वैज्ञानिक
vaigyanik	वैज्ञानिक	वैज्ञानिक
vegyanik	वेज्ञानिक	वैज्ञानिक
vaigyaanikta	वैज्ञानिकता	वैज्ञानिकता
vaigyanikata	वैज्ञानिकता	वैज्ञानिकता
vaigyanikta	वैज्ञानिकता	वैज्ञानिकता
vaitravati	वैत्रवती	वैत्रवती
vaitrawati	वैत्रवती	वैत्रवती
vaimanasy	वैमान्य	वैमनस्य
vaimanasya	वैमान्य	वैमनस्य
vaimanya	वैमान्य	वैमनस्य
very	वेरी	वैरी
vaisaakh	वैसाख	वैशाख
vaishakh	वैशाख	वैशाख
vaishaakhi	वैशाखी	वैशाखी
vaishakhi	वैशाखी	वैशाखी
vaishnodevi	वैश्नोदेवी	वैष्णोदेवी
vyaktigat	व्यक्तिगत	व्यक्तिगत
vyagr	व्याग्र	व्यग्र
vyagra	व्याग्र	व्यग्र
vyatit	व्यतित	व्यतीत
vytit	व्यतित	व्यतीत
vyabhichar	व्यभीचार	व्यभिचार
vyabhichari	व्यभीचारी	व्यभिचार
vyavadhan	व्यवाधन	व्यवधान
vyavdhan	व्यवधान	व्यवधान
vyavahargat	व्यवहारगत	व्यवहारगत
vyvhargat	व्यवहारत	व्यवहारगत
vyaghat	व्याघत	व्याघात
vyapak	व्यापक	व्यापक
vlad	व्लाद	व्लाद
wlaad	वलाद	व्लाद
vladimir	व्लादिमीर	व्लादिमीर
shanghai	शंघाई	शंघाई
shatpath	शत्पथ	शतपथ
shanivar	शानिवार	शनिवार
shaniwar	शानिवार	शनिवार
shabana	शबना	शबाना
shbana	शबाना	शबाना
shabdarth	शब्दर्थ	शब्दार्थ
shamadan	शमदान	शमादान
shmadan	शमदान	शमादान
shamitabh	शमीताभ	शमिताभ
shamil	शमील	शमिल
shmil	श्मील	शमिल
sharabon	शरबों	शराबों
shrabon	श्रबों	शराबों
shararat	शररत	शरारत
shrart	श्रात	शरारत
sharmana	शर्मना	शर्माना
shaharwasiyon	शहरवासियों	शहरवासियों
shahrvasiyon	शहरवासियों	शहरवासियों
shervasiyon	शेरवासियों	शहरवासियों
shahdara	शहदारा	शहादरा
shaantikaal	शांतिकाल	शांतिकाल
shantikal	शांतिकाल	शांतिकाल
shaao	शाओ	शाओ
shao	शाओ	शाओ
shaakir	शाकिर	शाकिर
shakir	शकीर	शाकिर
shaakhaaen	शाखाएं	शाखाएं
shakhayan	शखायां	शाखाएं
shakhayen	शखाएं	शाखाएं
shayak	शायक	शायक
shaavakon	शावकों	शावकों
shavakon	शवकों	शावकों
shavkon	शावकों	शावकों
shaasaka	शासका	शासक
shasak	शाक	शासक
sasakon	साकों	शासकों
shaasakon	शासकों	शासकों
shasakon	शाक्कों	शासकों
shipra	शिप्र	शिप्रा
shirke	शीरके	शिर्के
sheershakon	शीर्षकों	शीर्षकों
shirshakon	शीर्षकों	शीर्षकों
shirshkon	शीर्षकों	शीर्षकों
shujaat	शुजात	शुजात
shujat	शुजत	शुजात
shooting	शूटिंगगग	शुटिंग
shutting	श्ट्टिंगगग	शुटिंग
should	शौल्द	शुड
shud	शुद्द	शुड
shubhankar	शुभंकर	शुभंकर
shumaali	शुमाली	शुमाली
shumali	शुमली	शुमाली
shringaar	श्रृंगार	शृंगार
shringar	श्रृंगार	शृंगार
shrungar	श्रुंगर	शृंगार
sheling	शेलिंग	शेलिंग
shelling	शेलिंग	शेलिंग
shaili	शैली	शैली
shaly	शाल्य	शैली
sheli	शेली	शैली
shaishav	शैशव	शैशव
sean	सीन	शॉन
shaun	शौन	शॉन
shawn	शां	शॉन
short	शोर्ट	शोर्ट
sure	सुरे	श्योर
shrankhala	श्रंखला	श्रंखला
shrankhalaa	श्रंखला	श्रंखला
shrunkhla	श्रुंखला	श्रंखला
shrankhalaaon	श्रंखलाओं	श्रंखलाओं
shrinkhalaon	श्रृंखलाओं	श्रंखलाओं
shrunkhlaon	श्रुंखलाओं	श्रंखलाओं
shravani	श्रवाणी	श्रावणी
shrikar	श्रीकार	श्रीकर
shrikhand	श्रीखंड	श्रीखंड
shrimati	श्रीमती	श्रीमति
shriram	श्रीराम	श्रीराम
sriram	स्रीराम	श्रीराम
shrotaon	श्रोताओं	श्रोताओं
shat	शत	षट्
sankhyaein	संख्याएं	संख्याएं
sankhyaen	संख्याएं	संख्याएं
sankhyayen	संख्याएं	संख्याएं
sanghanit	संघनीत	संघनित
sanghnit	संघनीत	संघनित
sanchayan	संचायन	संचयन
sanchar	संचार	संचार
sanchaari	संचारी	संचारी
sanchari	संचारी	संचारी
sanchalanon	संचालनों	संचालनों
sanchalnon	संचलनों	संचालनों
sanjay	संजय	संजय
sanjeevan	संजीवन	संजीवन
sanjivan	संजीवन	संजीवन
santati	संतती	संतति
sandarbh	संदर्भ	संदर्भ
sandarbha	संदर्भ	संदर्भ
sandrbh	संद्रभ	संदर्भ
sandarbhon	संदर्भों	संदर्भों
sandrbhon	संद्रभों	संदर्भों
sandali	संदली	संदली
sandli	संंडली	संदली
sandhan	संंधन	संधान
samprati	संप्रति	संप्रति
samprti	संप्रति	संप्रति
samprabhu	संप्रभू	संप्रभु
samprbhu	संप्रभू	संप्रभु
samprabhuta	संप्रभूत	संप्रभुता
samprbhuta	संप्रभूत	संप्रभुता
sambit	संबित	संबित
sambhalane	संभालने	संभालने
sambhalne	संभलने	संभालने
sambhrant	संभरंत	संभ्रांत
sanbharnt	संभर्नत	संभ्रांत
sanyog	संयोग	संयुक्त
sanyukt	संयुक्त	संयुक्त
sanyukta	संयुक्त	संयुक्त
sanyukta	संयुक्त	संयुक्ता
sanyogvash	संयोगवाश	संयोगवश
sanyojan	संयोजन	संयोजन
sanyojanon	संयोजनों	संयोजनों
sanyojnon	संयोजनों	संयोजनों
samvedikaran	संवेदीकरण	संवेदीकरण
sanvedikaran	संवेदिकरण	संवेदीकरण
samshayon	समशायों	संशयों
sanshayon	संशयों	संशयों
sanshyon	संश्यों	संशयों
sanskaar	संस्कार	संस्कार
sanskar	संस्कार	संस्कार
sanskaari	संस्कारी	संस्कारी
sanskari	संस्कारी	संस्कारी
sanskrit	संस्कृत	संस्कृत
sanskurt	संस्कृत	संस्कृत
sanskritiyan	संस्कृतियां	संस्कृतियां
sanskrutiyan	संस्कृतियां	संस्कृतियां
sanskritiyon	संस्कृतियों	संस्कृतियों
sanskrutiyon	संस्कृतियों	संस्कृतियों
sanasthit	सनस्थित	संस्थित
sansthit	संस्थित	संस्थित
sanasthita	सनस्थिता	संस्थिता
sansthita	संस्थिता	संस्थिता
sakara	सकरा	सकरा
sakra	सक्र	सकरा
sakshan	सक्षण	सक्शन
suction	स्क्यून	सक्शन
sacchidanand	सच्चिदनंद	सच्चिदानंद
sachhidanand	सच्चिदनंद	सच्चिदानंद
sachidanand	सचीदननंद	सच्चिदानंद
sajja	सज्जा	सज्जा
sat	सत	सत
satpal	सत्पाल	सतपाल
satluj	सतलुज	सतलुज
sataane	सताने	सताने
satane	सतने	सताने
sate	सते	सते
satti	सत्ति	सत्ती
satvat	सत्वत	सत्वत
sadanand	सदानंद	सदानंद
sapane	सपने	सपने
sapne	सपने	सपने
sapney	सपने	सपने
saparivaar	सपरिवार	सपरिवार
sapariwar	सपरिवार	सपरिवार
sparivar	स्परिवार	सपरिवार
sapaat	सपात	सपाट
sapat	सपत	सपाट
sapate	सपते	सपाटे
sapatey	सपते	सपाटे
saptakranti	सप्तकरंती	सप्तक्रांति
saptkraanti	सप्तकरणंती	सप्तक्रांति
saptapadi	सप्तपपदी	सप्तपदी
saptpadi	सप्तपादी	सप्तपदी
saptari	सप्तरी	सप्तरी
sapramaan	सप्रमणण	सप्रमाण
sapraman	सप्रमण	सप्रमाण
submit	सुब्मित	सबमिट
sabmission	सब्मिसन	सबमिशन
submission	सब्मिसन	सबमिशन
sabhaein	सभाएं	सभाएं
sabhaen	सभाएं	सभाएं
sabhayen	सभाएं	सभाएं
sabhen	सभें	सभाएं
sabhasadon	सभासदों	सभासदों
sabhyata	सभ्यता	सभ्यता
samjhoonga	समझूंगा	समझूंगा
samjhunga	समझुंगा	समझूंगा
samjhungaa	समझुंगा	समझूंगा
saman	समन	समन
samanvayaka	समनवायका	समन्वयक
samanwayaka	समनवायका	समन्वयक
samnvyak	समन्वन्यक	समन्वयक
samaadhaan	समाधन	समाधान
samadhan	समाधन	समाधान
samadhiyon	समाधियों	समाधियों
samadjiyon	समद्जियों	समाधियों
samalakha	समालखा	समालखा
samalakhaa	समलाखा	समालखा
samahaar	समहार	समाहार
samahar	समहार	समाहार
samitiyan	समीतियां	समितियां
sametati	समेतती	समेटती
sametti	समेटी	समेटती
sarka	सरका	सरका
sarkaa	सरका	सरका
sarkarein	सरकारें	सरकारें
sarkaren	सरकारें	सरकारें
sarkaaron	सरकारों	सरकारों
sarkaron	सरकारों	सरकारों
sargana	सरगना	सरगना
sarganaon	सरगनाओं	सरगनाओं
sargi	सरगी	सरगी
sarguja	सरगुजा	सरगुजा
sarjuga	सर्जुगा	सरगुजा
sarsa	सरसा	सरसा
sarsaa	सरसा	सरसा
sarahind	सरहहंद	सरहिंद
sarhind	सारहिंद	सरहिंद
sirhind	सिरहिंद	सरहिंद
saraaha	सराहा	सराहा
saraha	सरहा	सराहा
saraahi	सराही	सराही
sarahi	सरही	सराही
salaahkar	सलाहकर	सलाहकार
salahkaar	सलहाकार	सलाहकार
salahkar	सलहाकार	सलाहकार
saleeb	सालीब	सलीब
salib	सालीब	सलीब
select	सेलेक्ट	सलेक्ट
saltanat	सलतनतत	सल्तनत
saltnat	सलत्नत	सल्तनत
savaal	सवाल	सवाल
saval	सवाल	सवाल
sawaal	सवाल	सवाल
sawal	सवाल	सवाल
sahakalaakar	सहकालर	सहकलाकार
sahakalakar	सहकालर	सहकलाकार
sahkalakar	सहकालर	सहकलाकार
sahadev	सहादेव	सहदेव
sahdev	सहदेव	सहदेव
sahrawat	सहरावत	सहरावत
sherawat	शेरावत	सहरावत
sahooliyata	सहूलियता	सहूलियत
sahuliyat	सहुलियत	सहूलियत
sahuuliyata	सहुलियता	सहूलियत
saanketika	सांकेतिका	सांकेतिक
sanketik	संकेतिक	सांकेतिक
saimans	सैमांस	साइमंस
simmons	सिम्मंस	साइमंस
symons	सायमंस	साइमंस
saima	सैमा	साइमा
sagarika	सगरीका	सागरिका
sagrika	सगगीका	सागरिका
saga	सागा	सागा
saajan	साजन	साजन
sajan	सजन	साजन
saajsajja	साजसजजजा	साजसज्जा
sajsajja	सजसजजजा	साजसज्जा
saja	सजा	साजा
saathsaath	साथसाथ	साथसाथ
sathsath	सथस्थ	साथसाथ
sathiya	साथिया	साथिया
saabah	साभा	साबाह
sabah	सबाह	साबाह
samanjasy	समंजनस्य	सामंजस्य
samanjasya	समंजनस्य	सामंजस्य
samoa	समोा	सामोआ
samoaa	समोा	सामोआ
saayn	सायन	सायं
sayan	सायन	सायं
saym	सायम	सायं
saira	सैरा	सायरा
sayara	सयारा	सायरा
sayra	सायरा	सायरा
salve	साल्वे	साल्वे
sahab	सहाब	साहब
singapore	सिंगपोर	सिंगापुर
singaar	सिंगार	सिंगार
singar	सिंगर	सिंगार
singer	सिंगर	सिंगार
singhaadey	सिंघाड़े	सिंघाड़े
singhade	सिंघड़े	सिंघाड़े
singhde	सिंघड़े	सिंघाड़े
singhre	सिंघरे	सिंघाड़े
singhi	सिंघी	सिंघी
singha	सिंघा	सिंहा
sinha	सिंहा	सिंहा
siera	सीरा	सिएरा
sierra	सीररा	सिएरा
sikud	सिकुड़	सिकुड़
signals	साइनल्स	सिगनल्स
cigaretton	सिगरेट्टन	सिगरेटों
cigretton	सिग्रेटन	सिगरेटों
siddhivat	सिद्धिवत	सिद्धवट
siddhvat	सिद्धवत	सिद्धवट
siddhwat	सिद्धवत	सिद्धवट
sinabang	सिनाबंग	सिनाबंग
synapse	सिनाप्स	सिनेप्स
sipah	सिपह	सिपाह
sipaha	सिपहा	सिपाह
sipahiyon	सिपहियों	सिपाहियों
sipahi	सिपही	सिपाही
sim	सीम	सिम
simat	सिमत	सिमट
simatataa	सिमतता	सिमटता
simatta	सिमत्ता	सिमटता
simtata	सिमताता	सिमटता
simtataa	सिमतता	सिमटता
cement	सेमेंट	सिमटे
simate	सिमते	सिमटे
simi	सीमी	सिमी
simmy	सिम्मी	सिमी
sims	सिम्स	सिम्स
siyasi	सियासी	सियासी
siyah	सियाह	सियाह
siyaha	सियाहा	सियाह
sirpur	सिरपुर	सिरपुर
sivan	सिवन	सिवान
siwan	सिवान	सिवान
sisva	सिस्व	सिसवा
siswa	सिस्वा	सिसवा
cil	सील	सीआईएल
csi	सीएसईईईईईईईईई	सीएसआई
sikar	सिकर	सीकर
seaten	सीटें	सीटें
sitaram	सीतराम	सीताराम
sitaharan	सीतहरण	सीताहरण
cpm	एसीीएम	सीपीएम
cps	एसीसीएस	सीपीएस
cbse	क्बीएस	सीबीएसई
seem	सीम	सीम
sim	सीम	सीम
sealed	सील्ड	सील्ड
shield	शील्ड	सील्ड
ccd	सीकीडीीी	सीसीडी
sugamata	सुगमता	सुगमता
sugmta	सुग्मता	सुगमता
sujan	सुजन	सुजेन
sujen	सुजें	सुजेन
suken	सुकें	सुजेन
sujain	सुजाइन	सुजैन
sujhaati	सुझाती	सुझाती
sujhati	सुझती	सुझाती
sutali	सुताली	सुतली
sutli	सूतली	सुतली
suta	सूता	सुता
sdueep	स्दीप	सुदीप
sudip	सुदीप	सुदीप
sudhaargrah	सुधारग्रह	सुधारगृह
sudhargrih	सुधारग्रहह	सुधारगृह
sudhargruh	सुधारगृह	सुधारगृह
sunaaron	सुनारों	सुनारों
sunaron	सुनारों	सुनारों
sunaseer	सुनसीर	सुनासीर
sunasir	सुनासिर	सुनासीर
suneeti	सुनीति	सुनीति
suniti	सुनीती	सुनीति
sunega	सुनेगा	सुनेगा
suneyga	सुनेगा	सुनेगा
superhit	सुपरहित	सुपरहिट
supachy	सुपच्य	सुपाच्य
supachya	सुपच्या	सुपाच्य
supachye	सुपच्य	सुपाच्य
subhaay	सुभाय	सुभाय
subhay	सुभाय	सुभाय
surveen	सुर्वीन	सुरवीन
survin	सुर्वीन	सुरवीन
surana	सुराना	सुराणा
sulkhan	सुल्खन	सुलखान
suljaayi	सुलजायी	सुलझाई
suljayi	सुलजाई	सुलझाई
suljhai	सुलझाई	सुलझाई
sulzai	सुलझाई	सुलझाई
sultana	सुल्तना	सुलताना
sulaati	सुलाती	सुलाती
sulati	सुलती	सुलाती
susanskrit	सुसंस्कृत	सुसंस्कृत
susanskrut	सुसंस्कृत	सुसंस्कृत
suhagin	सुहागीन	सुहागिन
soond	सूंद	सूंड़
sund	सुंद	सूंड़
suiyan	सुयां	सूइयां
sukhati	सुखती	सूखती
sukhti	सुखती	सूखती
sukhakar	सुखाकर	सूखाकर
soochak	सूचक	सूचक
suchak	सुचक	सूचक
sooja	सूजा	सूजा
suja	सुजा	सूजा
suba	सुबा	सूबा
sube	सबे	सूबे
sooraj	सूराज	सूरज
suraj	सुराज	सूरज
surinaam	सुरीनाम	सूरीनाम
surinama	सुरीनामा	सूरीनाम
suriname	सुरीनाम	सूरीनाम
suryadev	सुर्यादेव	सूर्यदेव
sendha	सेंधा	सेंधा
senvai	सेनवाई	सेंवई
sevai	सेवाई	सेंवई
sensing	सेंसिंग	सेंसिंग
sexual	सेक्सूल	सेक्सुअल
saturday	सतुर्दय	सेटरडे
seti	सेती	सेटी
seto	सेटो	सेटो
seth	सेठ	सेथ
safety	सफेटी	सेफ्टी
semen	सेमेन	सेमिन
semin	सेमिन	सेमिन
self	सेल्फ	सेल्फ
selfie	सेलफी	सेल्फी
save	सेव	सेव
sev	सेव	सेव
sevakon	सेवकों	सेवकों
sevkon	सेवकों	सेवकों
samuels	सममयल्स	सैम्युल्स
celery	सेलरी	सैलरी
salary	सालरी	सैलरी
sakar	सकर	सॉकर
socar	सोकार	सॉकर
soccer	सोक्सर	सॉकर
songs	सोंग्स	सॉन्ग्स
solicitor	सोलिक्टर	सॉलिसिटर
sochane	सोचने	सोचने
sochne	सोचने	सोचने
sonu	सोन्यू	सोनू
soma	सोमा	सोमा
spma	स्पीएमए	सोमा
somi	सोमी	सोमी
soy	सोय	सोय
soya	सोया	सोया
solitaire	सोलिएटर	सोलिटेयर
soharai	सोहराई	सोहराई
sohrai	सोहराई	सोहराई
sohaval	सोहवाल	सोहावल
sohawal	सोहवाल	सोहावल
saunpane	सौनपने	सौंपने
sonpne	सोनपने	सौंपने
scala	स्काला	स्काला
skala	स्काला	स्काला
ski	स्की	स्की
scootaron	स्कूटरों	स्कूटरों
scooteron	स्कूटरों	स्कूटरों
skootaron	स्कूटरों	स्कूटरों
scandinavia	स्कंंडिनवाई	स्कैंडिनेविया
scaining	स्केइनिंग	स्कैनिंग
scanning	स्केनिंग	स्कैनिंग
squash	स्क्वाश	स्क्वाश
squash	स्क्वाश	स्क्वैश
skhalan	स्खलन	स्खलन
stain	स्टेन	स्टैन
stan	स्टन	स्टैन
stop	स्टॉप	स्टॉप
stops	स्टॉप्स	स्टॉप्स
stone	स्टोन	स्टोन
straws	स्ट्राज	स्ट्रास
stress	स्ट्रेस	स्ट्रास
stra	स्त्रा	स्ट्रे
stray	स्ट्रे	स्ट्रे
stre	स्ट्रे	स्ट्रे
strocks	स्ट्रॉक्स	स्ट्रोक्स
strokes	स्ट्रोक्स	स्ट्रोक्स
stan	स्टन	स्तन
stanadhari	स्तानारी	स्तनधारी
standhaari	स्तांधारी	स्तनधारी
standhari	स्तांधारी	स्तनधारी
sthiti	स्थिती	स्तिथि
stithi	स्तिथी	स्तिथि
stuti	स्तुती	स्तुति
sthitiyaan	स्थितियां	स्थितियां
sthitiyan	स्थितियां	स्थितियां
sthitiyon	स्थितियों	स्थितियों
sthool	स्थूल	स्थूल
sthul	स्थूल	स्थूल
sthoolta	स्थूल्ता	स्थूलता
sthulata	स्थुलता	स्थूलता
sneakers	स्नेकर्स	स्नीकर्स
snickers	स्निक्रस	स्नीकर्स
snikarse	स्निकार्स	स्नीकर्स
spear	स्पीयर	स्पीयर
spell	स्पेल	स्पेल
spelar	स्पेलर	स्पेलर
speller	स्पेलर	स्पेलर
sprint	स्प्रिंट	स्प्रिट
sprit	स्प्रित	स्प्रिट
spray	स्प्रे	स्प्रे
spry	स्प्री	स्प्रे
sfoorti	स्फूर्ति	स्फूर्ति
sfurti	स्फूर्ति	स्फूर्ति
sphoorti	स्फूर्ति	स्फूर्ति
slide	स्लाइड	स्लाइड
slider	स्लाइडर	स्लाइडर
slaaidon	स्लाइडों	स्लाइडों
slidon	स्लीइनों	स्लाइडों
sliders	स्लाइड्स	स्लाइड्स
slides	स्लाइड्स	स्लाइड्स
slice	स्लाइस	स्लाइस
slash	स्लाश	स्लैश
swaroopon	स्वरूपों	स्वरुपों
swarupon	स्वरूपों	स्वरुपों
swa	स्वा	स्वा
swaachaalit	स्वाचालित	स्वाचालित
swachalit	स्वचालित	स्वाचालित
swaarthparak	स्वार्थपरक	स्वार्थपरक
swarthparak	स्वरर्थपरक	स्वार्थपरक
swiftlate	स्वाइटलेट	स्विफ्टलेट
swiftlet	स्विफ्टेट	स्विफ्टलेट
sweekarte	स्वीकारते	स्वीकारते
swikarte	स्वीकार्त	स्वीकारते
sweet	स्वीत	स्वीट
sweep	स्वीप	स्वीप
sweccha	स्वेच्छा	स्वेच्छा
swecha	स्वेच्छा	स्वेच्छा
swechha	स्वेच्छा	स्वेच्छा
sweta	स्वेटा	स्वेता
swap	स्वाप	स्वैप
swipe	स्वाइप	स्वैप
handiya	हंडीया	हंडिया
handiyaa	हंडिया	हंडिया
hundiya	हुंडिया	हंडिया
hakikat	हकीकत	हकीकत
haqeeqat	हकीकत	हकीकत
hathiya	हथिया	हथिया
hamala	हमाा	हमला
hamla	हमला	हमला
hamalavar	हमाावर	हमलावर
hamlavar	हमलावर	हमलावर
humlavar	हमलावर	हमलावर
hamaal	हमाल	हमाल
hamal	हमाल	हमाल
hercules	हे्क्यूसस	हरक्यूलिस
hardas	हरदास	हरदास
harpaal	हरपाल	हरपाल
harpal	हरपाल	हरपाल
harvansh	हरवांश	हरवंश
haraval	हरवाल	हरावल
harawal	हरवाल	हरावल
hurricane	हर्रीने	हरिकेन
harijan	हरीजन	हरिजन
hariyali	हरियाली	हरियाली
harshit	हर्षित	हर्षित
haldi	हल्दी	हल्दी
halla	हल्ला	हल्ला
hawamahal	हवामहल	हवामहल
hawalaat	हवालत	हवालात
hawalat	हवालत	हवालात
hasino	हैसिनो	हसीनों
hasinon	हासिनों	हसीनों
haan	हान	हां
han	हन	हां
haanfte	हानफते	हांफते
hafate	हफाते	हांफते
hanfte	हनफते	हांफते
higman	हाइमन	हाइमन
hymen	हाइमेन	हाइमन
hadauti	हडौती	हाड़ौती
haani	हानी	हानी
hani	हानी	हानी
haarjeet	हारजीत	हारजीत
harjeet	हरजीत	हारजीत
haaranaa	हारना	हारना
harana	हरना	हारना
harna	हरना	हारना
haalchaal	हालचाल	हालचाल
haalchal	हालच	हालचाल
halchaal	हलचाल	हालचाल
halchal	हलचाल	हालचाल
halt	हाल्ट	हाल्ट
hault	हॉल्ट	हाल्ट
hahakar	हहकर	हाहाकार
hingis	हिंगिसस	हिंगिस
hindan	हींदन	हिंडन
hindon	हींडों	हिंडन
hijada	हिजड़ा	हिजड़ा
hijda	हिजड़ा	हिजड़ा
hijbul	हिजबूल	हिजबुल
hippo	हीपपो	हिप्पो
hippopotamus	हिप्पोप्टम	हिप्पोपोटेमस
himali	हिमली	हिमाली
hilane	हिलने	हिलने
hilne	हिलने	हिलने
hisham	हिशम	हिशाम
heeraganj	हीरागंज	हीरागंज
hiraganj	हीरागंज	हीरागंज
heroes	हेरोज	हीरोज
heros	हेरोस	हीरोज
hui	हुई	हुईं
huin	हुईन	हुईं
hooper	हूपर	हूपर
huppar	हुप्पर	हूपर
hupper	हुप्र	हूपर
hegde	हेगड	हेगडे
hemvati	हेमवती	हेमवती
hemwati	हेमवती	हेमवती
help	हेल्प	हेल्प
helper	हेल्पर	हेल्पर
haito	हैटो	हैतो
hairam	हैराम	हैरम
harem	हरेम	हैरम
herald	हेरल्ड	हैराल्ड
haive	हैवे	हैव
have	हवे	हैव
hong	होंग	हॉन्ग
half	हालफ	हॉफ
hoaf	होफ	हॉफ
hounga	होंगा	होऊंगा
holding	होल्डिंग	होल्डिंग
hoshangabaad	होशंगाबाद	होशंगाबाद
hoshangabad	होशंगबाद	होशंगाबाद
hostes	हॉस्ट्स	होस्टेस
hostess	हॉस्टेस	होस्टेस
